"DATE","SIDO_ADDR","ROWCNT","PCNT","MED_Y_CNT","MED_N_CNT","MED_N_RATE"
2020-06-29 00:00:00,서울특별시,27975,18832,14643,13332,47.66
2020-06-29 00:00:00,경기도,10268,6759,5385,4883,47.56
2020-06-29 00:00:00,인천광역시,1661,1076,907,754,45.39
2020-06-29 00:00:00,서울,1377,1037,777,600,43.57
2020-06-29 00:00:00,충청남도,1269,791,638,631,49.72
2020-06-29 00:00:00,경상북도,1150,699,561,589,51.22
2020-06-29 00:00:00,강원도,961,624,513,448,46.62
2020-06-29 00:00:00,경상남도,895,533,428,467,52.18
2020-06-29 00:00:00,,654,505,414,240,36.7
2020-06-29 00:00:00,충청북도,766,472,413,353,46.08
2020-06-29 00:00:00,전라북도,742,454,361,381,51.35
2020-06-29 00:00:00,전라남도,735,434,369,366,49.8
2020-06-29 00:00:00,부산광역시,729,426,361,368,50.48
2020-06-29 00:00:00,대전광역시,629,392,315,314,49.92
2020-06-29 00:00:00,경기,437,325,231,206,47.14
2020-06-29 00:00:00,광주광역시,459,274,220,239,52.07
2020-06-29 00:00:00,대구광역시,437,268,208,229,52.4
2020-06-29 00:00:00,제주특별자치도,380,225,209,171,45
2020-06-29 00:00:00,울산광역시,307,184,150,157,51.14
2020-06-29 00:00:00,세종특별자치시,228,145,113,115,50.44
2020-06-29 00:00:00,인천광역,94,70,46,48,51.06
2020-06-29 00:00:00,충남,60,44,29,31,51.67
2020-06-29 00:00:00,인천,51,40,27,24,47.06
2020-06-29 00:00:00,경북,54,36,34,20,37.04
2020-06-29 00:00:00,강원,38,28,20,18,47.37
2020-06-29 00:00:00,경남,35,22,16,19,54.29
2020-06-29 00:00:00,전북,32,19,7,25,78.13
2020-06-29 00:00:00,부산광역,24,18,16,8,33.33
2020-06-29 00:00:00,광주광역,24,18,14,10,41.67
2020-06-29 00:00:00,충북,26,17,16,10,38.46
2020-06-29 00:00:00,전남,22,13,5,17,77.27
2020-06-29 00:00:00,대구,14,10,5,9,64.29
2020-06-29 00:00:00,대전광역,13,10,10,3,23.08
2020-06-29 00:00:00,대전,16,10,6,10,62.5
2020-06-29 00:00:00,부산,11,9,4,7,63.64
2020-06-29 00:00:00,대구광역,11,9,7,4,36.36
2020-06-29 00:00:00,★★★★★★★★,11,9,2,9,81.82
2020-06-29 00:00:00,광주,10,8,7,3,30
2020-06-29 00:00:00,울산,6,5,5,1,16.67
2020-06-29 00:00:00,제주,7,4,4,3,42.86
2020-06-29 00:00:00,남,5,4,3,2,40
2020-06-29 00:00:00,울산광역,5,3,2,3,60
2020-06-29 00:00:00,제주도,4,3,2,2,50
2020-06-29 00:00:00,기,3,3,3,0,0
2020-06-29 00:00:00,울,3,3,3,0,0
2020-06-29 00:00:00,서울강북구,3,2,1,2,66.67
2020-06-29 00:00:00,서울시,2,2,1,1,50
2020-06-29 00:00:00,북,1,1,1,0,0
2020-06-29 00:00:00,주,2,1,0,2,100
2020-06-29 00:00:00,광주시,2,1,1,1,50
2020-06-29 00:00:00,천,1,1,1,0,0
2020-06-29 00:00:00,대동@,1,1,1,0,0
2020-07-06 00:00:00,서울특별시,48380,30676,26498,21882,45.23
2020-07-06 00:00:00,경기도,17809,11061,9787,8022,45.04
2020-07-06 00:00:00,,6854,6632,694,6160,89.87
2020-07-06 00:00:00,서울,2607,1886,1361,1246,47.79
2020-07-06 00:00:00,인천광역시,2958,1788,1627,1331,45
2020-07-06 00:00:00,충청남도,2197,1342,1202,995,45.29
2020-07-06 00:00:00,경상북도,1995,1108,1026,969,48.57
2020-07-06 00:00:00,강원도,1737,1046,904,833,47.96
2020-07-06 00:00:00,경상남도,1555,891,811,744,47.85
2020-07-06 00:00:00,충청북도,1303,768,708,595,45.66
2020-07-06 00:00:00,전라남도,1328,719,687,641,48.27
2020-07-06 00:00:00,전라북도,1217,699,662,555,45.6
2020-07-06 00:00:00,부산광역시,1260,688,621,639,50.71
2020-07-06 00:00:00,대전광역시,1056,627,562,494,46.78
2020-07-06 00:00:00,경기,818,579,437,381,46.58
2020-07-06 00:00:00,대구광역시,861,509,445,416,48.32
2020-07-06 00:00:00,광주광역시,844,454,411,433,51.3
2020-07-06 00:00:00,제주특별자치도,740,370,367,373,50.41
2020-07-06 00:00:00,울산광역시,452,253,220,232,51.33
2020-07-06 00:00:00,세종특별자치시,343,199,179,164,47.81
2020-07-06 00:00:00,인천광역,157,107,81,76,48.41
2020-07-06 00:00:00,인천,126,88,71,55,43.65
2020-07-06 00:00:00,충남,105,71,53,52,49.52
2020-07-06 00:00:00,경북,81,52,38,43,53.09
2020-07-06 00:00:00,강원,72,48,39,33,45.83
2020-07-06 00:00:00,경남,51,38,23,28,54.9
2020-07-06 00:00:00,부산광역,52,33,26,26,50
2020-07-06 00:00:00,광주광역,41,29,24,17,41.46
2020-07-06 00:00:00,전북,46,28,27,19,41.3
2020-07-06 00:00:00,대전광역,34,26,13,21,61.76
2020-07-06 00:00:00,충북,35,23,19,16,45.71
2020-07-06 00:00:00,부산,33,19,17,16,48.48
2020-07-06 00:00:00,대구광역,27,18,13,14,51.85
2020-07-06 00:00:00,전남,28,17,16,12,42.86
2020-07-06 00:00:00,대구,33,17,8,25,75.76
2020-07-06 00:00:00,광주,23,17,17,6,26.09
2020-07-06 00:00:00,★★★★★★★★,21,16,11,10,47.62
2020-07-06 00:00:00,대전,27,13,14,13,48.15
2020-07-06 00:00:00,울산,17,11,10,7,41.18
2020-07-06 00:00:00,제주도,12,11,9,3,25
2020-07-06 00:00:00,제주,23,11,6,17,73.91
2020-07-06 00:00:00,울산광역,17,10,3,14,82.35
2020-07-06 00:00:00,울,12,9,6,6,50
2020-07-06 00:00:00,서울강북구,15,7,3,12,80
2020-07-06 00:00:00,기,7,5,4,3,42.86
2020-07-06 00:00:00,전,2,1,0,2,100
2020-07-06 00:00:00,서울시,2,1,0,2,100
2020-07-06 00:00:00,주,1,1,1,0,0
2020-07-06 00:00:00,북,2,1,0,2,100
2020-07-06 00:00:00,강서구,3,1,0,3,100
2020-07-06 00:00:00,원,1,1,1,0,0
2020-07-06 00:00:00,강북구,1,1,1,0,0
2020-07-06 00:00:00,광주시,1,1,1,0,0
2020-07-13 00:00:00,서울특별시,47840,30285,26615,21225,44.37
2020-07-13 00:00:00,경기도,17709,11012,9643,8066,45.55
2020-07-13 00:00:00,인천광역시,2879,1784,1554,1325,46.02
2020-07-13 00:00:00,서울,2421,1707,1374,1047,43.25
2020-07-13 00:00:00,충청남도,2203,1359,1192,1011,45.89
2020-07-13 00:00:00,경상북도,1911,1098,1009,902,47.2
2020-07-13 00:00:00,강원도,1733,1058,947,786,45.35
2020-07-13 00:00:00,경상남도,1647,930,833,814,49.42
2020-07-13 00:00:00,충청북도,1390,817,770,620,44.6
2020-07-13 00:00:00,,959,753,666,293,30.55
2020-07-13 00:00:00,전라남도,1291,709,693,598,46.32
2020-07-13 00:00:00,전라북도,1334,705,651,683,51.2
2020-07-13 00:00:00,부산광역시,1314,671,653,661,50.3
2020-07-13 00:00:00,대전광역시,1030,599,521,509,49.42
2020-07-13 00:00:00,경기,754,554,437,317,42.04
2020-07-13 00:00:00,대구광역시,888,484,457,431,48.54
2020-07-13 00:00:00,광주광역시,769,417,386,383,49.8
2020-07-13 00:00:00,제주특별자치도,651,337,353,298,45.78
2020-07-13 00:00:00,울산광역시,494,263,247,247,50
2020-07-13 00:00:00,세종특별자치시,326,191,192,134,41.1
2020-07-13 00:00:00,인천광역,118,93,69,49,41.53
2020-07-13 00:00:00,인천,89,60,41,48,53.93
2020-07-13 00:00:00,충남,85,59,50,35,41.18
2020-07-13 00:00:00,강원,71,47,35,36,50.7
2020-07-13 00:00:00,경남,62,41,30,32,51.61
2020-07-13 00:00:00,충북,42,34,24,18,42.86
2020-07-13 00:00:00,경북,52,33,26,26,50
2020-07-13 00:00:00,전남,49,28,19,30,61.22
2020-07-13 00:00:00,대구광역,35,23,18,17,48.57
2020-07-13 00:00:00,부산광역,29,22,16,13,44.83
2020-07-13 00:00:00,전북,35,22,14,21,60
2020-07-13 00:00:00,대전광역,30,20,12,18,60
2020-07-13 00:00:00,부산,31,20,17,14,45.16
2020-07-13 00:00:00,대전,24,19,9,15,62.5
2020-07-13 00:00:00,광주,26,16,9,17,65.38
2020-07-13 00:00:00,광주광역,20,14,7,13,65
2020-07-13 00:00:00,대구,25,14,17,8,32
2020-07-13 00:00:00,제주,19,13,11,8,42.11
2020-07-13 00:00:00,울산광역,13,11,9,4,30.77
2020-07-13 00:00:00,★★★★★★★★,12,11,5,7,58.33
2020-07-13 00:00:00,울,13,10,7,6,46.15
2020-07-13 00:00:00,울산,17,9,4,13,76.47
2020-07-13 00:00:00,제주도,13,7,8,5,38.46
2020-07-13 00:00:00,서울강북구,8,6,7,1,12.5
2020-07-13 00:00:00,기,6,3,3,3,50
2020-07-13 00:00:00,전,2,2,2,0,0
2020-07-13 00:00:00,강북구,2,2,2,0,0
2020-07-13 00:00:00,남,3,2,1,2,66.67
2020-07-13 00:00:00,북,1,1,1,0,0
2020-07-13 00:00:00,산,2,1,1,1,50
2020-07-13 00:00:00,원,1,1,1,0,0
2020-07-13 00:00:00,서울시,4,1,1,3,75
2020-07-13 00:00:00,강서구,1,1,1,0,0
2020-07-13 00:00:00,울주군,1,1,1,0,0
2020-07-13 00:00:00,천,1,1,1,0,0
2020-07-20 00:00:00,서울특별시,47698,30101,26548,21150,44.34
2020-07-20 00:00:00,경기도,17579,10905,9742,7837,44.58
2020-07-20 00:00:00,인천광역시,2966,1783,1692,1274,42.95
2020-07-20 00:00:00,서울,2283,1629,1302,981,42.97
2020-07-20 00:00:00,충청남도,2239,1368,1225,1014,45.29
2020-07-20 00:00:00,경상북도,2003,1150,1043,960,47.93
2020-07-20 00:00:00,강원도,1674,1022,931,743,44.38
2020-07-20 00:00:00,경상남도,1711,937,842,869,50.79
2020-07-20 00:00:00,충청북도,1340,797,752,588,43.88
2020-07-20 00:00:00,,955,769,693,262,27.43
2020-07-20 00:00:00,전라북도,1295,729,662,633,48.88
2020-07-20 00:00:00,부산광역시,1291,707,673,618,47.87
2020-07-20 00:00:00,전라남도,1242,699,657,585,47.1
2020-07-20 00:00:00,대전광역시,1157,653,580,577,49.87
2020-07-20 00:00:00,경기,826,565,441,385,46.61
2020-07-20 00:00:00,대구광역시,850,487,457,393,46.24
2020-07-20 00:00:00,광주광역시,735,416,385,350,47.62
2020-07-20 00:00:00,제주특별자치도,640,343,337,303,47.34
2020-07-20 00:00:00,울산광역시,490,274,246,244,49.8
2020-07-20 00:00:00,세종특별자치시,304,182,167,137,45.07
2020-07-20 00:00:00,인천광역,122,91,72,50,40.98
2020-07-20 00:00:00,인천,114,68,58,56,49.12
2020-07-20 00:00:00,충남,74,57,38,36,48.65
2020-07-20 00:00:00,경북,65,46,29,36,55.38
2020-07-20 00:00:00,강원,60,41,30,30,50
2020-07-20 00:00:00,충북,52,37,27,25,48.08
2020-07-20 00:00:00,전북,52,35,25,27,51.92
2020-07-20 00:00:00,경남,55,34,28,27,49.09
2020-07-20 00:00:00,전남,47,31,32,15,31.91
2020-07-20 00:00:00,부산광역,44,28,21,23,52.27
2020-07-20 00:00:00,대전,45,28,16,29,64.44
2020-07-20 00:00:00,광주광역,40,28,19,21,52.5
2020-07-20 00:00:00,대구광역,32,23,13,19,59.38
2020-07-20 00:00:00,부산,31,23,17,14,45.16
2020-07-20 00:00:00,대전광역,31,21,15,16,51.61
2020-07-20 00:00:00,광주,25,14,8,17,68
2020-07-20 00:00:00,대구,26,12,7,19,73.08
2020-07-20 00:00:00,울,12,11,8,4,33.33
2020-07-20 00:00:00,서울강북구,15,10,6,9,60
2020-07-20 00:00:00,★★★★★★★★,13,10,6,7,53.85
2020-07-20 00:00:00,울산,13,9,10,3,23.08
2020-07-20 00:00:00,제주,15,9,7,8,53.33
2020-07-20 00:00:00,제주도,16,7,8,8,50
2020-07-20 00:00:00,울산광역,5,3,3,2,40
2020-07-20 00:00:00,남,4,2,4,0,0
2020-07-20 00:00:00,강북구,6,2,1,5,83.33
2020-07-20 00:00:00,원,3,2,1,2,66.67
2020-07-20 00:00:00,서울관악구봉천1동,1,1,1,0,0
2020-07-20 00:00:00,경기용인시풍덕천2동,1,1,1,0,0
2020-07-20 00:00:00,서울강북구번3동,2,1,1,1,50
2020-07-20 00:00:00,서울시,3,1,1,2,66.67
2020-07-20 00:00:00,기,1,1,1,0,0
2020-07-20 00:00:00,경기도화성시송산동,2,1,1,1,50
2020-07-20 00:00:00,광진구,2,1,1,1,50
2020-07-20 00:00:00,남동구만수2동,1,1,1,0,0
2020-07-27 00:00:00,서울특별시,45832,29097,25223,20609,44.97
2020-07-27 00:00:00,경기도,17158,10726,9226,7932,46.23
2020-07-27 00:00:00,인천광역시,2836,1718,1498,1338,47.18
2020-07-27 00:00:00,서울,2205,1574,1224,981,44.49
2020-07-27 00:00:00,충청남도,2159,1321,1143,1016,47.06
2020-07-27 00:00:00,경상북도,1989,1130,967,1022,51.38
2020-07-27 00:00:00,강원도,1577,963,840,737,46.73
2020-07-27 00:00:00,경상남도,1604,892,829,775,48.32
2020-07-27 00:00:00,충청북도,1382,800,728,654,47.32
2020-07-27 00:00:00,,970,756,682,288,29.69
2020-07-27 00:00:00,전라북도,1263,705,659,604,47.82
2020-07-27 00:00:00,전라남도,1190,671,574,616,51.76
2020-07-27 00:00:00,대전광역시,1109,641,582,527,47.52
2020-07-27 00:00:00,부산광역시,1127,615,588,539,47.83
2020-07-27 00:00:00,경기,725,526,382,343,47.31
2020-07-27 00:00:00,대구광역시,861,476,440,421,48.9
2020-07-27 00:00:00,광주광역시,770,419,376,394,51.17
2020-07-27 00:00:00,제주특별자치도,617,329,317,300,48.62
2020-07-27 00:00:00,울산광역시,498,290,264,234,46.99
2020-07-27 00:00:00,세종특별자치시,340,202,187,153,45
2020-07-27 00:00:00,인천광역,120,85,65,55,45.83
2020-07-27 00:00:00,인천,83,63,42,41,49.4
2020-07-27 00:00:00,충남,86,63,47,39,45.35
2020-07-27 00:00:00,경북,78,48,37,41,52.56
2020-07-27 00:00:00,강원,62,45,37,25,40.32
2020-07-27 00:00:00,충북,62,43,35,27,43.55
2020-07-27 00:00:00,전북,62,39,32,30,48.39
2020-07-27 00:00:00,경남,56,37,30,26,46.43
2020-07-27 00:00:00,부산광역,38,24,16,22,57.89
2020-07-27 00:00:00,광주광역,38,24,20,18,47.37
2020-07-27 00:00:00,대전,30,22,16,14,46.67
2020-07-27 00:00:00,전남,29,21,13,16,55.17
2020-07-27 00:00:00,부산,35,20,17,18,51.43
2020-07-27 00:00:00,대구광역,24,20,14,10,41.67
2020-07-27 00:00:00,대전광역,27,17,14,13,48.15
2020-07-27 00:00:00,광주,30,17,12,18,60
2020-07-27 00:00:00,대구,16,11,9,7,43.75
2020-07-27 00:00:00,서울강북구,14,11,7,7,50
2020-07-27 00:00:00,★★★★★★★★,16,11,5,11,68.75
2020-07-27 00:00:00,울산,13,9,8,5,38.46
2020-07-27 00:00:00,제주,11,8,6,5,45.45
2020-07-27 00:00:00,울,9,8,9,0,0
2020-07-27 00:00:00,울산광역,7,6,2,5,71.43
2020-07-27 00:00:00,제주도,9,6,5,4,44.44
2020-07-27 00:00:00,천,2,2,2,0,0
2020-07-27 00:00:00,서울시,5,2,1,4,80
2020-07-27 00:00:00,산,4,2,3,1,25
2020-07-27 00:00:00,기,4,2,1,3,75
2020-07-27 00:00:00,강북구,3,2,1,2,66.67
2020-07-27 00:00:00,원주시,5,1,2,3,60
2020-07-27 00:00:00,북,2,1,0,2,100
2020-07-27 00:00:00,남동구만수2동,2,1,0,2,100
2020-07-27 00:00:00,남,1,1,1,0,0
2020-08-03 00:00:00,서울특별시,45733,29050,24625,21108,46.15
2020-08-03 00:00:00,경기도,17157,10753,9017,8140,47.44
2020-08-03 00:00:00,인천광역시,2894,1723,1521,1373,47.44
2020-08-03 00:00:00,서울,2237,1584,1225,1012,45.24
2020-08-03 00:00:00,충청남도,2172,1329,1153,1019,46.92
2020-08-03 00:00:00,경상북도,1929,1113,979,950,49.25
2020-08-03 00:00:00,강원도,1561,945,809,752,48.17
2020-08-03 00:00:00,경상남도,1662,915,786,876,52.71
2020-08-03 00:00:00,충청북도,1308,788,697,611,46.71
2020-08-03 00:00:00,,1056,787,659,397,37.59
2020-08-03 00:00:00,전라북도,1380,753,655,725,52.54
2020-08-03 00:00:00,전라남도,1282,691,647,635,49.53
2020-08-03 00:00:00,부산광역시,1245,676,601,644,51.73
2020-08-03 00:00:00,대전광역시,1110,613,529,581,52.34
2020-08-03 00:00:00,경기,731,522,405,326,44.6
2020-08-03 00:00:00,대구광역시,901,509,463,438,48.61
2020-08-03 00:00:00,광주광역시,801,457,407,394,49.19
2020-08-03 00:00:00,제주특별자치도,595,330,315,280,47.06
2020-08-03 00:00:00,울산광역시,483,281,253,230,47.62
2020-08-03 00:00:00,세종특별자치시,327,211,179,148,45.26
2020-08-03 00:00:00,인천광역,132,90,71,61,46.21
2020-08-03 00:00:00,충남,91,60,57,34,37.36
2020-08-03 00:00:00,인천,79,58,46,33,41.77
2020-08-03 00:00:00,경북,76,52,38,38,50
2020-08-03 00:00:00,경남,74,41,27,47,63.51
2020-08-03 00:00:00,전북,51,36,28,23,45.1
2020-08-03 00:00:00,충북,53,32,16,37,69.81
2020-08-03 00:00:00,강원,53,31,28,25,47.17
2020-08-03 00:00:00,부산,34,24,17,17,50
2020-08-03 00:00:00,광주광역,33,23,19,14,42.42
2020-08-03 00:00:00,부산광역,30,21,19,11,36.67
2020-08-03 00:00:00,광주,31,18,11,20,64.52
2020-08-03 00:00:00,울산,28,18,16,12,42.86
2020-08-03 00:00:00,대전광역,28,17,11,17,60.71
2020-08-03 00:00:00,대구광역,28,17,18,10,35.71
2020-08-03 00:00:00,대구,32,16,11,21,65.63
2020-08-03 00:00:00,전남,22,15,13,9,40.91
2020-08-03 00:00:00,★★★★★★★★,21,15,10,11,52.38
2020-08-03 00:00:00,대전,22,13,8,14,63.64
2020-08-03 00:00:00,제주,16,10,5,11,68.75
2020-08-03 00:00:00,서울강북구,12,9,6,6,50
2020-08-03 00:00:00,울산광역,12,8,7,5,41.67
2020-08-03 00:00:00,울,13,8,4,9,69.23
2020-08-03 00:00:00,제주도,12,8,6,6,50
2020-08-03 00:00:00,기,5,5,5,0,0
2020-08-03 00:00:00,서울시,7,4,2,5,71.43
2020-08-03 00:00:00,원주시,1,1,1,0,0
2020-08-03 00:00:00,천,3,1,0,3,100
2020-08-03 00:00:00,원,2,1,2,0,0
2020-08-03 00:00:00,강북구,2,1,1,1,50
2020-08-03 00:00:00,북,1,1,0,1,100
2020-08-03 00:00:00,산,2,1,2,0,0
2020-08-10 00:00:00,서울특별시,46888,30000,26194,20694,44.13
2020-08-10 00:00:00,경기도,17698,11069,9739,7959,44.97
2020-08-10 00:00:00,인천광역시,2926,1766,1585,1341,45.83
2020-08-10 00:00:00,서울,2281,1644,1321,960,42.09
2020-08-10 00:00:00,충청남도,2254,1387,1279,975,43.26
2020-08-10 00:00:00,경상북도,1911,1156,1036,875,45.79
2020-08-10 00:00:00,강원도,1639,995,886,753,45.94
2020-08-10 00:00:00,경상남도,1693,961,901,792,46.78
2020-08-10 00:00:00,충청북도,1402,836,809,593,42.3
2020-08-10 00:00:00,전라남도,1411,786,690,721,51.1
2020-08-10 00:00:00,전라북도,1307,768,705,602,46.06
2020-08-10 00:00:00,,1039,765,638,401,38.59
2020-08-10 00:00:00,부산광역시,1223,686,648,575,47.02
2020-08-10 00:00:00,대전광역시,1141,658,642,499,43.73
2020-08-10 00:00:00,대구광역시,992,572,556,436,43.95
2020-08-10 00:00:00,경기,756,528,417,339,44.84
2020-08-10 00:00:00,광주광역시,788,452,439,349,44.29
2020-08-10 00:00:00,제주특별자치도,606,328,303,303,50
2020-08-10 00:00:00,울산광역시,538,310,292,246,45.72
2020-08-10 00:00:00,세종특별자치시,363,221,196,167,46.01
2020-08-10 00:00:00,인천광역,131,86,62,69,52.67
2020-08-10 00:00:00,경북,97,63,54,43,44.33
2020-08-10 00:00:00,인천,79,60,43,36,45.57
2020-08-10 00:00:00,충남,78,50,41,37,47.44
2020-08-10 00:00:00,강원,74,45,40,34,45.95
2020-08-10 00:00:00,충북,58,40,21,37,63.79
2020-08-10 00:00:00,경남,62,36,32,30,48.39
2020-08-10 00:00:00,전남,38,28,18,20,52.63
2020-08-10 00:00:00,전북,45,25,22,23,51.11
2020-08-10 00:00:00,부산광역,34,24,19,15,44.12
2020-08-10 00:00:00,부산,38,22,21,17,44.74
2020-08-10 00:00:00,광주광역,39,22,22,17,43.59
2020-08-10 00:00:00,대구,30,20,17,13,43.33
2020-08-10 00:00:00,★★★★★★★★,21,17,9,12,57.14
2020-08-10 00:00:00,광주,38,15,11,27,71.05
2020-08-10 00:00:00,대전,24,14,13,11,45.83
2020-08-10 00:00:00,대전광역,19,14,10,9,47.37
2020-08-10 00:00:00,대구광역,15,11,11,4,26.67
2020-08-10 00:00:00,서울강북구,12,11,7,5,41.67
2020-08-10 00:00:00,울산,11,8,7,4,36.36
2020-08-10 00:00:00,울,7,7,5,2,28.57
2020-08-10 00:00:00,서울시,8,5,4,4,50
2020-08-10 00:00:00,제주도,6,5,3,3,50
2020-08-10 00:00:00,울산광역,9,5,4,5,55.56
2020-08-10 00:00:00,제주,6,4,2,4,66.67
2020-08-10 00:00:00,세종시,2,1,2,0,0
2020-08-10 00:00:00,상주시,2,1,1,1,50
2020-08-10 00:00:00,남,1,1,1,0,0
2020-08-10 00:00:00,경기도양주군회천읍,1,1,0,1,100
2020-08-10 00:00:00,산,2,1,2,0,0
2020-08-10 00:00:00,북,2,1,2,0,0
2020-08-10 00:00:00,기,1,1,1,0,0
2020-08-17 00:00:00,서울특별시,42475,26984,21967,20508,48.28
2020-08-17 00:00:00,경기도,15598,9760,8074,7524,48.24
2020-08-17 00:00:00,인천광역시,2698,1630,1390,1308,48.48
2020-08-17 00:00:00,서울,2021,1427,1107,914,45.23
2020-08-17 00:00:00,충청남도,1876,1154,980,896,47.76
2020-08-17 00:00:00,경상북도,1674,963,778,896,53.52
2020-08-17 00:00:00,강원도,1431,874,690,741,51.78
2020-08-17 00:00:00,경상남도,1422,803,680,742,52.18
2020-08-17 00:00:00,충청북도,1212,713,634,578,47.69
2020-08-17 00:00:00,,864,704,599,265,30.67
2020-08-17 00:00:00,전라북도,1188,676,539,649,54.63
2020-08-17 00:00:00,부산광역시,1162,637,552,610,52.5
2020-08-17 00:00:00,전라남도,1161,607,576,585,50.39
2020-08-17 00:00:00,대전광역시,891,535,454,437,49.05
2020-08-17 00:00:00,경기,782,531,391,391,50
2020-08-17 00:00:00,대구광역시,817,467,409,408,49.94
2020-08-17 00:00:00,광주광역시,636,352,306,330,51.89
2020-08-17 00:00:00,제주특별자치도,590,314,267,323,54.75
2020-08-17 00:00:00,울산광역시,405,232,204,201,49.63
2020-08-17 00:00:00,세종특별자치시,267,166,135,132,49.44
2020-08-17 00:00:00,인천광역,115,81,56,59,51.3
2020-08-17 00:00:00,충남,71,47,34,37,52.11
2020-08-17 00:00:00,경북,76,47,38,38,50
2020-08-17 00:00:00,인천,69,46,39,30,43.48
2020-08-17 00:00:00,경남,71,45,34,37,52.11
2020-08-17 00:00:00,충북,68,37,30,38,55.88
2020-08-17 00:00:00,강원,55,37,27,28,50.91
2020-08-17 00:00:00,전북,40,28,12,28,70
2020-08-17 00:00:00,전남,32,23,11,21,65.63
2020-08-17 00:00:00,광주,31,21,15,16,51.61
2020-08-17 00:00:00,대전,34,21,17,17,50
2020-08-17 00:00:00,광주광역,34,21,11,23,67.65
2020-08-17 00:00:00,부산,35,20,12,23,65.71
2020-08-17 00:00:00,부산광역,25,18,7,18,72
2020-08-17 00:00:00,대전광역,25,17,17,8,32
2020-08-17 00:00:00,★★★★★★★★,13,11,4,9,69.23
2020-08-17 00:00:00,대구광역,13,10,7,6,46.15
2020-08-17 00:00:00,울,15,10,7,8,53.33
2020-08-17 00:00:00,대구,18,10,5,13,72.22
2020-08-17 00:00:00,울산광역,15,10,8,7,46.67
2020-08-17 00:00:00,제주,7,7,6,1,14.29
2020-08-17 00:00:00,울산,10,7,6,4,40
2020-08-17 00:00:00,서울시,9,5,3,6,66.67
2020-08-17 00:00:00,서울강북구,4,4,2,2,50
2020-08-17 00:00:00,제주도,8,3,4,4,50
2020-08-17 00:00:00,남,6,3,4,2,33.33
2020-08-17 00:00:00,기,3,2,1,2,66.67
2020-08-17 00:00:00,천,1,1,0,1,100
2020-08-17 00:00:00,산,4,1,3,1,25
2020-08-17 00:00:00,주,3,1,2,1,33.33
2020-08-17 00:00:00,경기도화성시송산동,1,1,0,1,100
2020-08-17 00:00:00,서울관악구봉천1동,1,1,1,0,0
2020-08-24 00:00:00,서울특별시,42161,26200,22136,20025,47.5
2020-08-24 00:00:00,경기도,15890,9777,8246,7644,48.11
2020-08-24 00:00:00,인천광역시,2700,1619,1326,1374,50.89
2020-08-24 00:00:00,서울,2046,1424,1041,1005,49.12
2020-08-24 00:00:00,충청남도,1706,1038,893,813,47.66
2020-08-24 00:00:00,경상북도,1579,909,764,815,51.61
2020-08-24 00:00:00,강원도,1430,852,684,746,52.17
2020-08-24 00:00:00,경상남도,1346,751,635,711,52.82
2020-08-24 00:00:00,충청북도,1158,670,562,596,51.47
2020-08-24 00:00:00,,814,634,541,273,33.54
2020-08-24 00:00:00,전라북도,1110,625,517,593,53.42
2020-08-24 00:00:00,부산광역시,1112,616,536,576,51.8
2020-08-24 00:00:00,전라남도,1067,594,552,515,48.27
2020-08-24 00:00:00,대전광역시,996,571,517,479,48.09
2020-08-24 00:00:00,경기,739,513,364,375,50.74
2020-08-24 00:00:00,대구광역시,786,420,365,421,53.56
2020-08-24 00:00:00,광주광역시,669,376,326,343,51.27
2020-08-24 00:00:00,제주특별자치도,565,304,272,293,51.86
2020-08-24 00:00:00,울산광역시,462,253,244,218,47.19
2020-08-24 00:00:00,세종특별자치시,272,161,136,136,50
2020-08-24 00:00:00,인천광역,114,78,57,57,50
2020-08-24 00:00:00,인천,73,56,38,35,47.95
2020-08-24 00:00:00,충남,78,53,41,37,47.44
2020-08-24 00:00:00,경북,75,47,36,39,52
2020-08-24 00:00:00,충북,61,45,36,25,40.98
2020-08-24 00:00:00,강원,69,44,25,44,63.77
2020-08-24 00:00:00,경남,44,28,19,25,56.82
2020-08-24 00:00:00,대전광역,34,24,13,21,61.76
2020-08-24 00:00:00,광주광역,29,21,14,15,51.72
2020-08-24 00:00:00,광주,26,21,15,11,42.31
2020-08-24 00:00:00,전남,40,21,10,30,75
2020-08-24 00:00:00,부산광역,31,20,14,17,54.84
2020-08-24 00:00:00,대전,31,19,12,19,61.29
2020-08-24 00:00:00,전북,26,18,15,11,42.31
2020-08-24 00:00:00,★★★★★★★★,20,16,6,14,70
2020-08-24 00:00:00,부산,19,12,13,6,31.58
2020-08-24 00:00:00,대구,17,11,6,11,64.71
2020-08-24 00:00:00,대구광역,9,7,7,2,22.22
2020-08-24 00:00:00,서울강북구,11,7,6,5,45.45
2020-08-24 00:00:00,울산,10,7,4,6,60
2020-08-24 00:00:00,제주도,6,5,2,4,66.67
2020-08-24 00:00:00,제주,8,5,2,6,75
2020-08-24 00:00:00,울,6,5,3,3,50
2020-08-24 00:00:00,울산광역,7,3,5,2,28.57
2020-08-24 00:00:00,서울시,3,2,1,2,66.67
2020-08-24 00:00:00,북,1,1,1,0,0
2020-08-24 00:00:00,기,1,1,0,1,100
2020-08-24 00:00:00,천,1,1,1,0,0
2020-08-24 00:00:00,산,2,1,2,0,0
2020-08-24 00:00:00,원주시,1,1,1,0,0
2020-08-24 00:00:00,남,1,1,1,0,0
2020-08-31 00:00:00,서울특별시,42652,26199,22679,19973,46.83
2020-08-31 00:00:00,경기도,15133,9474,7832,7301,48.25
2020-08-31 00:00:00,인천광역시,2590,1533,1336,1254,48.42
2020-08-31 00:00:00,서울,2054,1450,1064,990,48.2
2020-08-31 00:00:00,충청남도,1817,1046,926,891,49.04
2020-08-31 00:00:00,경상북도,1486,852,674,812,54.64
2020-08-31 00:00:00,강원도,1387,835,681,706,50.9
2020-08-31 00:00:00,충청북도,1117,683,575,542,48.52
2020-08-31 00:00:00,경상남도,1246,666,555,691,55.46
2020-08-31 00:00:00,,832,612,487,345,41.47
2020-08-31 00:00:00,전라북도,1056,586,499,557,52.75
2020-08-31 00:00:00,대전광역시,959,547,454,505,52.66
2020-08-31 00:00:00,부산광역시,928,524,455,473,50.97
2020-08-31 00:00:00,전라남도,954,514,444,510,53.46
2020-08-31 00:00:00,경기,592,435,296,296,50
2020-08-31 00:00:00,대구광역시,721,380,326,395,54.79
2020-08-31 00:00:00,광주광역시,605,350,314,291,48.1
2020-08-31 00:00:00,제주특별자치도,485,264,202,283,58.35
2020-08-31 00:00:00,울산광역시,358,204,157,201,56.15
2020-08-31 00:00:00,세종특별자치시,277,167,130,147,53.07
2020-08-31 00:00:00,인천광역,117,86,58,59,50.43
2020-08-31 00:00:00,인천,85,61,39,46,54.12
2020-08-31 00:00:00,충남,64,45,34,30,46.88
2020-08-31 00:00:00,경남,53,36,26,27,50.94
2020-08-31 00:00:00,강원,47,32,22,25,53.19
2020-08-31 00:00:00,경북,51,30,16,35,68.63
2020-08-31 00:00:00,부산광역,39,25,16,23,58.97
2020-08-31 00:00:00,충북,29,21,14,15,51.72
2020-08-31 00:00:00,전북,31,21,9,22,70.97
2020-08-31 00:00:00,광주광역,25,21,15,10,40
2020-08-31 00:00:00,전남,33,21,15,18,54.55
2020-08-31 00:00:00,대전광역,30,19,13,17,56.67
2020-08-31 00:00:00,★★★★★★★★,18,17,6,12,66.67
2020-08-31 00:00:00,대전,29,17,12,17,58.62
2020-08-31 00:00:00,광주,19,16,13,6,31.58
2020-08-31 00:00:00,대구,13,9,4,9,69.23
2020-08-31 00:00:00,부산,11,9,6,5,45.45
2020-08-31 00:00:00,울산,15,8,8,7,46.67
2020-08-31 00:00:00,울,9,7,6,3,33.33
2020-08-31 00:00:00,서울강북구,9,7,4,5,55.56
2020-08-31 00:00:00,제주,11,6,6,5,45.45
2020-08-31 00:00:00,제주도,5,4,3,2,40
2020-08-31 00:00:00,울산광역,4,3,2,2,50
2020-08-31 00:00:00,서울시,6,3,1,5,83.33
2020-08-31 00:00:00,대구광역,3,3,2,1,33.33
2020-08-31 00:00:00,기,4,2,1,3,75
2020-08-31 00:00:00,천,4,2,0,4,100
2020-08-31 00:00:00,원주시,1,1,1,0,0
2020-08-31 00:00:00,경기도용인시서천동,1,1,0,1,100
2020-08-31 00:00:00,산,3,1,0,3,100
2020-08-31 00:00:00,주,2,1,1,1,50
2020-08-31 00:00:00,남,6,1,0,6,100
2020-08-31 00:00:00,북,2,1,1,1,50
2020-09-07 00:00:00,서울특별시,44714,27659,24483,20231,45.25
2020-09-07 00:00:00,경기도,16474,10183,8851,7623,46.27
2020-09-07 00:00:00,인천광역시,2738,1642,1468,1270,46.38
2020-09-07 00:00:00,서울,2102,1481,1110,992,47.19
2020-09-07 00:00:00,충청남도,1938,1179,1050,888,45.82
2020-09-07 00:00:00,경상북도,1634,962,797,837,51.22
2020-09-07 00:00:00,강원도,1445,882,748,697,48.24
2020-09-07 00:00:00,경상남도,1445,774,720,725,50.17
2020-09-07 00:00:00,충청북도,1196,706,662,534,44.65
2020-09-07 00:00:00,,856,653,520,336,39.25
2020-09-07 00:00:00,전라북도,1147,629,584,563,49.08
2020-09-07 00:00:00,대전광역시,1026,611,535,491,47.86
2020-09-07 00:00:00,전라남도,1103,602,556,547,49.59
2020-09-07 00:00:00,부산광역시,1125,586,516,609,54.13
2020-09-07 00:00:00,경기,742,517,399,343,46.23
2020-09-07 00:00:00,대구광역시,830,442,404,426,51.33
2020-09-07 00:00:00,광주광역시,755,415,345,410,54.3
2020-09-07 00:00:00,제주특별자치도,552,284,265,287,51.99
2020-09-07 00:00:00,울산광역시,428,232,188,240,56.07
2020-09-07 00:00:00,세종특별자치시,344,189,178,166,48.26
2020-09-07 00:00:00,인천광역,123,88,70,53,43.09
2020-09-07 00:00:00,인천,93,61,47,46,49.46
2020-09-07 00:00:00,충남,83,52,36,47,56.63
2020-09-07 00:00:00,강원,59,42,30,29,49.15
2020-09-07 00:00:00,경북,53,34,26,27,50.94
2020-09-07 00:00:00,경남,46,27,12,34,73.91
2020-09-07 00:00:00,전북,26,22,13,13,50
2020-09-07 00:00:00,전남,24,20,19,5,20.83
2020-09-07 00:00:00,대전,37,20,10,27,72.97
2020-09-07 00:00:00,대전광역,22,18,8,14,63.64
2020-09-07 00:00:00,부산광역,22,17,15,7,31.82
2020-09-07 00:00:00,광주광역,21,15,10,11,52.38
2020-09-07 00:00:00,광주,17,13,12,5,29.41
2020-09-07 00:00:00,충북,19,13,8,11,57.89
2020-09-07 00:00:00,부산,20,12,6,14,70
2020-09-07 00:00:00,★★★★★★★★,15,12,3,12,80
2020-09-07 00:00:00,울산,20,11,7,13,65
2020-09-07 00:00:00,제주도,12,10,3,9,75
2020-09-07 00:00:00,대구광역,13,10,5,8,61.54
2020-09-07 00:00:00,대구,14,9,7,7,50
2020-09-07 00:00:00,제주,16,9,6,10,62.5
2020-09-07 00:00:00,울,8,7,5,3,37.5
2020-09-07 00:00:00,서울강북구,7,4,2,5,71.43
2020-09-07 00:00:00,기,8,4,3,5,62.5
2020-09-07 00:00:00,울산광역,4,4,3,1,25
2020-09-07 00:00:00,서울시,6,3,1,5,83.33
2020-09-07 00:00:00,천,4,3,4,0,0
2020-09-07 00:00:00,산,3,1,1,2,66.67
2020-09-07 00:00:00,경기용인시풍덕천2동,1,1,0,1,100
2020-09-07 00:00:00,경기도용인시서천동,1,1,0,1,100
2020-09-07 00:00:00,주,2,1,0,2,100
2020-09-07 00:00:00,남,1,1,1,0,0
2020-09-07 00:00:00,경기의왕시포일동,2,1,1,1,50
2020-09-14 00:00:00,서울특별시,46640,29593,26345,20295,43.51
2020-09-14 00:00:00,경기도,17156,10802,9647,7509,43.77
2020-09-14 00:00:00,서울,2429,1693,1363,1066,43.89
2020-09-14 00:00:00,인천광역시,2657,1659,1511,1146,43.13
2020-09-14 00:00:00,충청남도,1961,1220,1056,905,46.15
2020-09-14 00:00:00,경상북도,1728,1022,897,831,48.09
2020-09-14 00:00:00,강원도,1637,986,889,748,45.69
2020-09-14 00:00:00,,975,779,655,320,32.82
2020-09-14 00:00:00,경상남도,1386,774,716,670,48.34
2020-09-14 00:00:00,충청북도,1240,747,672,568,45.81
2020-09-14 00:00:00,전라남도,1200,661,590,610,50.83
2020-09-14 00:00:00,전라북도,1160,644,587,573,49.4
2020-09-14 00:00:00,부산광역시,1161,642,572,589,50.73
2020-09-14 00:00:00,대전광역시,1055,626,577,478,45.31
2020-09-14 00:00:00,경기,685,497,412,273,39.85
2020-09-14 00:00:00,대구광역시,802,448,397,405,50.5
2020-09-14 00:00:00,광주광역시,725,403,382,343,47.31
2020-09-14 00:00:00,제주특별자치도,577,328,298,279,48.35
2020-09-14 00:00:00,울산광역시,446,249,244,202,45.29
2020-09-14 00:00:00,세종특별자치시,298,179,163,135,45.3
2020-09-14 00:00:00,인천광역,111,84,59,52,46.85
2020-09-14 00:00:00,인천,105,75,60,45,42.86
2020-09-14 00:00:00,충남,86,56,36,50,58.14
2020-09-14 00:00:00,강원,57,41,29,28,49.12
2020-09-14 00:00:00,경북,59,39,33,26,44.07
2020-09-14 00:00:00,경남,41,27,20,21,51.22
2020-09-14 00:00:00,대전광역,38,25,16,22,57.89
2020-09-14 00:00:00,대전,53,24,15,38,71.7
2020-09-14 00:00:00,부산,39,23,15,24,61.54
2020-09-14 00:00:00,부산광역,35,22,14,21,60
2020-09-14 00:00:00,충북,31,20,14,17,54.84
2020-09-14 00:00:00,전남,29,19,12,17,58.62
2020-09-14 00:00:00,전북,24,15,13,11,45.83
2020-09-14 00:00:00,광주광역,22,15,9,13,59.09
2020-09-14 00:00:00,★★★★★★★★,16,14,9,7,43.75
2020-09-14 00:00:00,대구,23,14,13,10,43.48
2020-09-14 00:00:00,울산,17,12,12,5,29.41
2020-09-14 00:00:00,광주,14,10,8,6,42.86
2020-09-14 00:00:00,대구광역,11,9,6,5,45.45
2020-09-14 00:00:00,울산광역,13,8,5,8,61.54
2020-09-14 00:00:00,울,10,7,5,5,50
2020-09-14 00:00:00,기,9,6,2,7,77.78
2020-09-14 00:00:00,제주,18,6,2,16,88.89
2020-09-14 00:00:00,서울강북구,8,6,6,2,25
2020-09-14 00:00:00,서울시,7,5,3,4,57.14
2020-09-14 00:00:00,제주도,4,3,3,1,25
2020-09-14 00:00:00,원,2,2,2,0,0
2020-09-14 00:00:00,남,3,2,1,2,66.67
2020-09-14 00:00:00,산,2,2,1,1,50
2020-09-14 00:00:00,서울관악구봉천1동,2,2,2,0,0
2020-09-14 00:00:00,경기도화성시송산동,1,1,1,0,0
2020-09-14 00:00:00,전,1,1,1,0,0
2020-09-14 00:00:00,주,1,1,1,0,0
2020-09-14 00:00:00,서대문구,1,1,1,0,0
2020-09-14 00:00:00,인천직할시,1,1,1,0,0
2020-09-14 00:00:00,경기용인시풍덕천2동,2,1,1,1,50
2020-09-14 00:00:00,서구,2,1,0,2,100
2020-09-14 00:00:00,강북구,2,1,0,2,100
2020-09-21 00:00:00,서울특별시,50042,31198,28489,21553,43.07
2020-09-21 00:00:00,경기도,18738,11532,10571,8167,43.59
2020-09-21 00:00:00,인천광역시,3106,1859,1683,1423,45.81
2020-09-21 00:00:00,서울,2430,1733,1427,1003,41.28
2020-09-21 00:00:00,충청남도,2122,1278,1158,964,45.43
2020-09-21 00:00:00,경상북도,1922,1081,1006,916,47.66
2020-09-21 00:00:00,강원도,1782,1028,973,809,45.4
2020-09-21 00:00:00,경상남도,1564,846,819,745,47.63
2020-09-21 00:00:00,충청북도,1414,818,782,632,44.7
2020-09-21 00:00:00,,990,772,665,325,32.83
2020-09-21 00:00:00,전라남도,1389,744,728,661,47.59
2020-09-21 00:00:00,부산광역시,1278,704,642,636,49.77
2020-09-21 00:00:00,전라북도,1197,673,636,561,46.87
2020-09-21 00:00:00,대전광역시,1149,648,634,515,44.82
2020-09-21 00:00:00,경기,781,547,432,349,44.69
2020-09-21 00:00:00,대구광역시,856,461,447,409,47.78
2020-09-21 00:00:00,광주광역시,836,455,452,384,45.93
2020-09-21 00:00:00,제주특별자치도,617,332,330,287,46.52
2020-09-21 00:00:00,울산광역시,442,250,217,225,50.9
2020-09-21 00:00:00,세종특별자치시,313,190,189,124,39.62
2020-09-21 00:00:00,인천광역,138,100,87,51,36.96
2020-09-21 00:00:00,인천,91,65,49,42,46.15
2020-09-21 00:00:00,강원,82,56,42,40,48.78
2020-09-21 00:00:00,충남,69,50,43,26,37.68
2020-09-21 00:00:00,경북,53,39,32,21,39.62
2020-09-21 00:00:00,경남,64,37,21,43,67.19
2020-09-21 00:00:00,충북,46,33,24,22,47.83
2020-09-21 00:00:00,전북,43,29,28,15,34.88
2020-09-21 00:00:00,광주광역,36,28,15,21,58.33
2020-09-21 00:00:00,전남,39,26,14,25,64.1
2020-09-21 00:00:00,대전광역,36,24,19,17,47.22
2020-09-21 00:00:00,대전,34,21,23,11,32.35
2020-09-21 00:00:00,대구광역,28,20,14,14,50
2020-09-21 00:00:00,부산광역,25,20,12,13,52
2020-09-21 00:00:00,부산,34,19,17,17,50
2020-09-21 00:00:00,광주,22,13,13,9,40.91
2020-09-21 00:00:00,대구,17,13,10,7,41.18
2020-09-21 00:00:00,★★★★★★★★,12,10,8,4,33.33
2020-09-21 00:00:00,울산,12,9,5,7,58.33
2020-09-21 00:00:00,제주,9,7,5,4,44.44
2020-09-21 00:00:00,서울강북구,7,6,4,3,42.86
2020-09-21 00:00:00,울,6,6,5,1,16.67
2020-09-21 00:00:00,제주도,7,6,4,3,42.86
2020-09-21 00:00:00,울산광역,7,6,6,1,14.29
2020-09-21 00:00:00,서울시,7,4,2,5,71.43
2020-09-21 00:00:00,북,6,3,4,2,33.33
2020-09-21 00:00:00,기,7,3,4,3,42.86
2020-09-21 00:00:00,강북구,2,2,2,0,0
2020-09-21 00:00:00,남,3,2,1,2,66.67
2020-09-21 00:00:00,서구,3,1,1,2,66.67
2020-09-21 00:00:00,광주시,2,1,1,1,50
2020-09-21 00:00:00,산,3,1,3,0,0
2020-09-21 00:00:00,인천직할시,1,1,1,0,0
2020-09-21 00:00:00,광진구,1,1,1,0,0
2020-09-28 00:00:00,서울특별시,22082,15320,12303,9779,44.28
2020-09-28 00:00:00,경기도,8032,5411,4480,3552,44.22
2020-09-28 00:00:00,인천광역시,1447,940,812,635,43.88
2020-09-28 00:00:00,서울,953,727,532,421,44.18
2020-09-28 00:00:00,충청남도,735,500,406,329,44.76
2020-09-28 00:00:00,강원도,634,427,373,261,41.17
2020-09-28 00:00:00,경상북도,661,427,300,361,54.61
2020-09-28 00:00:00,충청북도,567,367,302,265,46.74
2020-09-28 00:00:00,경상남도,550,326,240,310,56.36
2020-09-28 00:00:00,,408,319,275,133,32.6
2020-09-28 00:00:00,대전광역시,462,270,247,215,46.54
2020-09-28 00:00:00,부산광역시,443,266,210,233,52.6
2020-09-28 00:00:00,전라북도,410,265,207,203,49.51
2020-09-28 00:00:00,경기,320,242,186,134,41.88
2020-09-28 00:00:00,전라남도,399,237,193,206,51.63
2020-09-28 00:00:00,광주광역시,262,169,136,126,48.09
2020-09-28 00:00:00,대구광역시,294,161,135,159,54.08
2020-09-28 00:00:00,제주특별자치도,239,142,125,114,47.7
2020-09-28 00:00:00,울산광역시,178,104,87,91,51.12
2020-09-28 00:00:00,세종특별자치시,138,81,67,71,51.45
2020-09-28 00:00:00,인천광역,50,37,31,19,38
2020-09-28 00:00:00,인천,43,30,26,17,39.53
2020-09-28 00:00:00,충남,32,25,17,15,46.88
2020-09-28 00:00:00,강원,27,22,18,9,33.33
2020-09-28 00:00:00,경북,26,18,11,15,57.69
2020-09-28 00:00:00,충북,19,15,9,10,52.63
2020-09-28 00:00:00,경남,16,13,8,8,50
2020-09-28 00:00:00,부산광역,16,11,5,11,68.75
2020-09-28 00:00:00,전남,16,9,5,11,68.75
2020-09-28 00:00:00,전북,11,8,6,5,45.45
2020-09-28 00:00:00,★★★★★★★★,9,8,5,4,44.44
2020-09-28 00:00:00,대전,10,8,4,6,60
2020-09-28 00:00:00,대전광역,10,7,8,2,20
2020-09-28 00:00:00,대구,9,6,4,5,55.56
2020-09-28 00:00:00,광주,7,5,2,5,71.43
2020-09-28 00:00:00,대구광역,4,4,4,0,0
2020-09-28 00:00:00,제주,4,3,2,2,50
2020-09-28 00:00:00,울,4,3,1,3,75
2020-09-28 00:00:00,제주도,3,3,1,2,66.67
2020-09-28 00:00:00,기,4,2,1,3,75
2020-09-28 00:00:00,부산,2,2,1,1,50
2020-09-28 00:00:00,서울강북구,2,2,2,0,0
2020-09-28 00:00:00,울산,4,2,3,1,25
2020-09-28 00:00:00,광주광역,3,2,1,2,66.67
2020-09-28 00:00:00,울산광역,1,1,1,0,0
2020-09-28 00:00:00,서울시,1,1,1,0,0
2020-09-28 00:00:00,남,1,1,1,0,0
2020-09-28 00:00:00,인천시,1,1,1,0,0
2020-09-28 00:00:00,원주시,2,1,0,2,100
2020-10-05 00:00:00,서울특별시,44843,28705,25159,19684,43.9
2020-10-05 00:00:00,경기도,16629,10311,9207,7422,44.63
2020-10-05 00:00:00,인천광역시,2934,1752,1598,1336,45.54
2020-10-05 00:00:00,서울,2023,1475,1182,841,41.57
2020-10-05 00:00:00,충청남도,1952,1181,1061,891,45.65
2020-10-05 00:00:00,경상북도,1808,1063,939,869,48.06
2020-10-05 00:00:00,강원도,1564,947,883,681,43.54
2020-10-05 00:00:00,경상남도,1484,823,776,708,47.71
2020-10-05 00:00:00,충청북도,1278,759,714,564,44.13
2020-10-05 00:00:00,,885,702,644,241,27.23
2020-10-05 00:00:00,전라남도,1244,670,632,612,49.2
2020-10-05 00:00:00,전라북도,1163,666,642,521,44.8
2020-10-05 00:00:00,부산광역시,1207,642,638,569,47.14
2020-10-05 00:00:00,대전광역시,1090,605,586,504,46.24
2020-10-05 00:00:00,경기,680,488,389,291,42.79
2020-10-05 00:00:00,대구광역시,792,442,426,366,46.21
2020-10-05 00:00:00,광주광역시,746,404,399,347,46.51
2020-10-05 00:00:00,제주특별자치도,590,322,310,280,47.46
2020-10-05 00:00:00,울산광역시,444,243,220,224,50.45
2020-10-05 00:00:00,세종특별자치시,343,206,200,143,41.69
2020-10-05 00:00:00,인천광역,111,89,66,45,40.54
2020-10-05 00:00:00,인천,74,53,39,35,47.3
2020-10-05 00:00:00,충남,67,51,37,30,44.78
2020-10-05 00:00:00,경북,67,44,30,37,55.22
2020-10-05 00:00:00,강원,46,33,21,25,54.35
2020-10-05 00:00:00,충북,45,30,23,22,48.89
2020-10-05 00:00:00,전북,40,29,27,13,32.5
2020-10-05 00:00:00,전남,40,27,20,20,50
2020-10-05 00:00:00,경남,36,26,21,15,41.67
2020-10-05 00:00:00,부산,33,21,16,17,51.52
2020-10-05 00:00:00,부산광역,25,17,20,5,20
2020-10-05 00:00:00,울산,21,16,13,8,38.1
2020-10-05 00:00:00,광주,27,16,10,17,62.96
2020-10-05 00:00:00,대전광역,22,16,11,11,50
2020-10-05 00:00:00,대전,18,15,13,5,27.78
2020-10-05 00:00:00,대구광역,19,14,10,9,47.37
2020-10-05 00:00:00,★★★★★★★★,16,12,8,8,50
2020-10-05 00:00:00,대구,19,11,8,11,57.89
2020-10-05 00:00:00,광주광역,13,11,6,7,53.85
2020-10-05 00:00:00,제주,12,7,5,7,58.33
2020-10-05 00:00:00,제주도,7,5,5,2,28.57
2020-10-05 00:00:00,울,4,4,3,1,25
2020-10-05 00:00:00,서울강북구,4,4,3,1,25
2020-10-05 00:00:00,울산광역,4,3,1,3,75
2020-10-05 00:00:00,기,4,3,1,3,75
2020-10-05 00:00:00,남,3,2,3,0,0
2020-10-05 00:00:00,서울시,4,2,1,3,75
2020-10-05 00:00:00,경기용인시풍덕천2동,1,1,1,0,0
2020-10-05 00:00:00,북,1,1,0,1,100
2020-10-05 00:00:00,광진구,1,1,1,0,0
2020-10-05 00:00:00,강북구,1,1,1,0,0
2020-10-05 00:00:00,산,2,1,2,0,0
2020-10-12 00:00:00,서울특별시,42786,27677,23380,19406,45.36
2020-10-12 00:00:00,경기도,15841,10008,8617,7224,45.6
2020-10-12 00:00:00,인천광역시,2659,1617,1415,1244,46.78
2020-10-12 00:00:00,서울,1975,1442,1086,889,45.01
2020-10-12 00:00:00,충청남도,1940,1182,1050,890,45.88
2020-10-12 00:00:00,경상북도,1716,1001,897,819,47.73
2020-10-12 00:00:00,강원도,1532,916,784,748,48.83
2020-10-12 00:00:00,경상남도,1520,850,761,759,49.93
2020-10-12 00:00:00,,1014,794,727,287,28.3
2020-10-12 00:00:00,충청북도,1253,747,710,543,43.34
2020-10-12 00:00:00,전라남도,1258,700,609,649,51.59
2020-10-12 00:00:00,부산광역시,1140,623,585,555,48.68
2020-10-12 00:00:00,전라북도,1034,618,505,529,51.16
2020-10-12 00:00:00,대전광역시,1031,574,512,519,50.34
2020-10-12 00:00:00,경기,652,474,367,285,43.71
2020-10-12 00:00:00,대구광역시,749,420,392,357,47.66
2020-10-12 00:00:00,광주광역시,722,404,373,349,48.34
2020-10-12 00:00:00,제주특별자치도,531,280,270,261,49.15
2020-10-12 00:00:00,울산광역시,437,251,233,204,46.68
2020-10-12 00:00:00,세종특별자치시,298,182,161,137,45.97
2020-10-12 00:00:00,인천광역,107,83,53,54,50.47
2020-10-12 00:00:00,인천,74,59,37,37,50
2020-10-12 00:00:00,충남,77,58,42,35,45.45
2020-10-12 00:00:00,강원,48,36,20,28,58.33
2020-10-12 00:00:00,경북,49,35,25,24,48.98
2020-10-12 00:00:00,경남,48,33,24,24,50
2020-10-12 00:00:00,충북,47,27,21,26,55.32
2020-10-12 00:00:00,전북,34,26,17,17,50
2020-10-12 00:00:00,전남,42,24,24,18,42.86
2020-10-12 00:00:00,부산광역,37,23,15,22,59.46
2020-10-12 00:00:00,광주광역,31,21,16,15,48.39
2020-10-12 00:00:00,대전,37,20,16,21,56.76
2020-10-12 00:00:00,대전광역,24,17,10,14,58.33
2020-10-12 00:00:00,부산,22,17,14,8,36.36
2020-10-12 00:00:00,대구광역,21,17,15,6,28.57
2020-10-12 00:00:00,광주,24,14,10,14,58.33
2020-10-12 00:00:00,대구,27,14,7,20,74.07
2020-10-12 00:00:00,★★★★★★★★,18,13,7,11,61.11
2020-10-12 00:00:00,울,15,12,10,5,33.33
2020-10-12 00:00:00,울산,13,7,8,5,38.46
2020-10-12 00:00:00,울산광역,10,6,4,6,60
2020-10-12 00:00:00,서울강북구,7,5,4,3,42.86
2020-10-12 00:00:00,기,7,4,2,5,71.43
2020-10-12 00:00:00,제주도,6,4,1,5,83.33
2020-10-12 00:00:00,제주,6,3,1,5,83.33
2020-10-12 00:00:00,남,4,3,1,3,75
2020-10-12 00:00:00,서울시,4,3,3,1,25
2020-10-12 00:00:00,산,1,1,1,0,0
2020-10-12 00:00:00,강북구,1,1,1,0,0
2020-10-12 00:00:00,세종시,1,1,1,0,0
2020-10-12 00:00:00,북,1,1,0,1,100
2020-10-12 00:00:00,천,1,1,1,0,0
2020-10-12 00:00:00,서울관악구봉천1동,1,1,1,0,0
2020-10-12 00:00:00,전,4,1,0,4,100
2020-10-19 00:00:00,서울특별시,50844,32197,28315,22529,44.31
2020-10-19 00:00:00,경기도,18762,11732,10513,8249,43.97
2020-10-19 00:00:00,인천광역시,3003,1822,1700,1303,43.39
2020-10-19 00:00:00,서울,2509,1783,1444,1065,42.45
2020-10-19 00:00:00,충청남도,2225,1354,1194,1031,46.34
2020-10-19 00:00:00,,1498,1292,671,827,55.21
2020-10-19 00:00:00,경상북도,2017,1160,1054,963,47.74
2020-10-19 00:00:00,강원도,1914,1126,1027,887,46.34
2020-10-19 00:00:00,경상남도,1680,940,856,824,49.05
2020-10-19 00:00:00,충청북도,1549,892,830,719,46.42
2020-10-19 00:00:00,전라남도,1395,816,739,656,47.03
2020-10-19 00:00:00,전라북도,1270,773,657,613,48.27
2020-10-19 00:00:00,부산광역시,1385,759,699,686,49.53
2020-10-19 00:00:00,대전광역시,1217,673,675,542,44.54
2020-10-19 00:00:00,경기,769,562,428,341,44.34
2020-10-19 00:00:00,대구광역시,917,511,499,418,45.58
2020-10-19 00:00:00,광주광역시,861,479,436,425,49.36
2020-10-19 00:00:00,제주특별자치도,670,362,399,271,40.45
2020-10-19 00:00:00,울산광역시,556,313,279,277,49.82
2020-10-19 00:00:00,세종특별자치시,380,240,217,163,42.89
2020-10-19 00:00:00,인천광역,158,111,91,67,42.41
2020-10-19 00:00:00,인천,121,86,73,48,39.67
2020-10-19 00:00:00,충남,98,63,46,52,53.06
2020-10-19 00:00:00,강원,79,54,38,41,51.9
2020-10-19 00:00:00,경북,60,44,38,22,36.67
2020-10-19 00:00:00,경남,65,43,34,31,47.69
2020-10-19 00:00:00,충북,47,34,27,20,42.55
2020-10-19 00:00:00,전남,50,32,25,25,50
2020-10-19 00:00:00,부산광역,51,30,25,26,50.98
2020-10-19 00:00:00,대전광역,35,28,19,16,45.71
2020-10-19 00:00:00,전북,38,25,15,23,60.53
2020-10-19 00:00:00,대전,33,22,22,11,33.33
2020-10-19 00:00:00,광주광역,35,22,18,17,48.57
2020-10-19 00:00:00,★★★★★★★★,24,19,12,12,50
2020-10-19 00:00:00,부산,25,19,16,9,36
2020-10-19 00:00:00,대구,26,17,13,13,50
2020-10-19 00:00:00,광주,26,14,10,16,61.54
2020-10-19 00:00:00,대구광역,18,13,9,9,50
2020-10-19 00:00:00,제주,16,10,8,8,50
2020-10-19 00:00:00,울산,16,10,6,10,62.5
2020-10-19 00:00:00,울,11,8,8,3,27.27
2020-10-19 00:00:00,제주도,11,8,4,7,63.64
2020-10-19 00:00:00,서울강북구,7,6,5,2,28.57
2020-10-19 00:00:00,울산광역,7,6,5,2,28.57
2020-10-19 00:00:00,기,5,3,3,2,40
2020-10-19 00:00:00,남,3,3,3,0,0
2020-10-19 00:00:00,천,2,2,1,1,50
2020-10-19 00:00:00,산,3,2,3,0,0
2020-10-19 00:00:00,경기용인시풍덕천2동,1,1,1,0,0
2020-10-19 00:00:00,북,1,1,1,0,0
2020-10-19 00:00:00,서대문구,1,1,1,0,0
2020-10-19 00:00:00,전,1,1,1,0,0
2020-10-19 00:00:00,인천시,2,1,0,2,100
2020-10-19 00:00:00,서울시,3,1,1,2,66.67
2020-10-26 00:00:00,서울특별시,49305,31282,27468,21837,44.29
2020-10-26 00:00:00,경기도,18354,11423,10082,8272,45.07
2020-10-26 00:00:00,인천광역시,2961,1771,1623,1338,45.19
2020-10-26 00:00:00,서울,2387,1711,1295,1092,45.75
2020-10-26 00:00:00,충청남도,2158,1313,1139,1019,47.22
2020-10-26 00:00:00,경상북도,1997,1138,1017,980,49.07
2020-10-26 00:00:00,강원도,1734,1049,947,787,45.39
2020-10-26 00:00:00,경상남도,1547,899,790,757,48.93
2020-10-26 00:00:00,충청북도,1429,840,761,668,46.75
2020-10-26 00:00:00,,945,778,692,253,26.77
2020-10-26 00:00:00,전라남도,1301,762,686,615,47.27
2020-10-26 00:00:00,부산광역시,1339,730,682,657,49.07
2020-10-26 00:00:00,전라북도,1211,696,625,586,48.39
2020-10-26 00:00:00,대전광역시,1143,648,584,559,48.91
2020-10-26 00:00:00,경기,825,587,449,376,45.58
2020-10-26 00:00:00,대구광역시,894,505,466,428,47.87
2020-10-26 00:00:00,광주광역시,874,473,456,418,47.83
2020-10-26 00:00:00,제주특별자치도,696,353,361,335,48.13
2020-10-26 00:00:00,울산광역시,536,296,284,252,47.01
2020-10-26 00:00:00,세종특별자치시,362,222,204,158,43.65
2020-10-26 00:00:00,인천광역,131,95,74,57,43.51
2020-10-26 00:00:00,경남,88,61,37,51,57.95
2020-10-26 00:00:00,인천,78,60,43,35,44.87
2020-10-26 00:00:00,충남,96,58,43,53,55.21
2020-10-26 00:00:00,강원,70,49,34,36,51.43
2020-10-26 00:00:00,경북,74,48,40,34,45.95
2020-10-26 00:00:00,충북,53,37,30,23,43.4
2020-10-26 00:00:00,부산광역,56,30,27,29,51.79
2020-10-26 00:00:00,대전광역,38,28,21,17,44.74
2020-10-26 00:00:00,전북,37,23,24,13,35.14
2020-10-26 00:00:00,전남,34,22,18,16,47.06
2020-10-26 00:00:00,★★★★★★★★,25,22,13,12,48
2020-10-26 00:00:00,부산,34,21,10,24,70.59
2020-10-26 00:00:00,대전,25,19,12,13,52
2020-10-26 00:00:00,광주,30,18,17,13,43.33
2020-10-26 00:00:00,대구,35,18,15,20,57.14
2020-10-26 00:00:00,광주광역,27,17,15,12,44.44
2020-10-26 00:00:00,대구광역,26,16,12,14,53.85
2020-10-26 00:00:00,제주도,17,12,12,5,29.41
2020-10-26 00:00:00,울산,17,12,9,8,47.06
2020-10-26 00:00:00,제주,14,11,8,6,42.86
2020-10-26 00:00:00,서울강북구,13,11,9,4,30.77
2020-10-26 00:00:00,울산광역,13,10,8,5,38.46
2020-10-26 00:00:00,울,12,10,5,7,58.33
2020-10-26 00:00:00,강북구,3,2,1,2,66.67
2020-10-26 00:00:00,서울시,1,1,0,1,100
2020-10-26 00:00:00,세종시,2,1,2,0,0
2020-10-26 00:00:00,남,1,1,1,0,0
2020-10-26 00:00:00,강동구,1,1,1,0,0
2020-10-26 00:00:00,경기도화성시송산동,2,1,2,0,0
2020-10-26 00:00:00,인헌12다길,1,1,1,0,0
2020-10-26 00:00:00,원,2,1,0,2,100
2020-10-26 00:00:00,기,2,1,2,0,0
2020-10-26 00:00:00,산,2,1,2,0,0
2020-10-26 00:00:00,경기용인시풍덕천2동,2,1,2,0,0
2020-11-02 00:00:00,서울특별시,50244,31913,27902,22342,44.47
2020-11-02 00:00:00,경기도,18494,11527,10157,8337,45.08
2020-11-02 00:00:00,인천광역시,2960,1791,1608,1352,45.68
2020-11-02 00:00:00,서울,2510,1758,1380,1130,45.02
2020-11-02 00:00:00,충청남도,2137,1318,1162,975,45.62
2020-11-02 00:00:00,경상북도,1963,1144,1026,937,47.73
2020-11-02 00:00:00,강원도,1795,1061,956,839,46.74
2020-11-02 00:00:00,경상남도,1648,902,821,827,50.18
2020-11-02 00:00:00,,1080,861,763,317,29.35
2020-11-02 00:00:00,충청북도,1457,854,802,655,44.96
2020-11-02 00:00:00,전라남도,1412,791,723,689,48.8
2020-11-02 00:00:00,부산광역시,1325,731,699,626,47.25
2020-11-02 00:00:00,전라북도,1255,725,651,604,48.13
2020-11-02 00:00:00,대전광역시,1092,638,622,470,43.04
2020-11-02 00:00:00,경기,799,565,445,354,44.31
2020-11-02 00:00:00,대구광역시,952,524,518,434,45.59
2020-11-02 00:00:00,광주광역시,843,474,443,400,47.45
2020-11-02 00:00:00,제주특별자치도,661,356,336,325,49.17
2020-11-02 00:00:00,울산광역시,549,308,276,273,49.73
2020-11-02 00:00:00,세종특별자치시,378,216,193,185,48.94
2020-11-02 00:00:00,인천광역,138,101,79,59,42.75
2020-11-02 00:00:00,인천,108,71,55,53,49.07
2020-11-02 00:00:00,충남,98,61,45,53,54.08
2020-11-02 00:00:00,강원,82,56,38,44,53.66
2020-11-02 00:00:00,경북,81,52,40,41,50.62
2020-11-02 00:00:00,경남,70,47,35,35,50
2020-11-02 00:00:00,부산광역,58,35,28,30,51.72
2020-11-02 00:00:00,전북,41,33,20,21,51.22
2020-11-02 00:00:00,광주광역,35,24,19,16,45.71
2020-11-02 00:00:00,충북,32,23,18,14,43.75
2020-11-02 00:00:00,대전,39,22,16,23,58.97
2020-11-02 00:00:00,대전광역,32,21,16,16,50
2020-11-02 00:00:00,광주,29,21,15,14,48.28
2020-11-02 00:00:00,전남,38,21,13,25,65.79
2020-11-02 00:00:00,대구광역,24,16,10,14,58.33
2020-11-02 00:00:00,★★★★★★★★,23,16,8,15,65.22
2020-11-02 00:00:00,대구,23,15,13,10,43.48
2020-11-02 00:00:00,부산,26,14,13,13,50
2020-11-02 00:00:00,울산,20,14,15,5,25
2020-11-02 00:00:00,울,13,11,8,5,38.46
2020-11-02 00:00:00,제주도,12,8,5,7,58.33
2020-11-02 00:00:00,서울강북구,9,8,9,0,0
2020-11-02 00:00:00,제주,12,7,6,6,50
2020-11-02 00:00:00,울산광역,7,6,6,1,14.29
2020-11-02 00:00:00,기,5,5,3,2,40
2020-11-02 00:00:00,강북구,4,3,1,3,75
2020-11-02 00:00:00,서울시,2,2,1,1,50
2020-11-02 00:00:00,원,3,1,2,1,33.33
2020-11-02 00:00:00,천,1,1,1,0,0
2020-11-02 00:00:00,서대문구,1,1,1,0,0
2020-11-02 00:00:00,(주소불명)1119,2,1,1,1,50
2020-11-02 00:00:00,산,2,1,2,0,0
2020-11-02 00:00:00,인천시,1,1,1,0,0
2020-11-02 00:00:00,경남마산시해운동,3,1,2,1,33.33
2020-11-09 00:00:00,서울특별시,49377,31175,27213,22164,44.89
2020-11-09 00:00:00,경기도,18362,11388,10086,8276,45.07
2020-11-09 00:00:00,인천광역시,3109,1854,1644,1465,47.12
2020-11-09 00:00:00,서울,2397,1699,1318,1079,45.01
2020-11-09 00:00:00,충청남도,2171,1365,1219,952,43.85
2020-11-09 00:00:00,경상북도,1967,1150,1024,943,47.94
2020-11-09 00:00:00,강원도,1683,1023,931,752,44.68
2020-11-09 00:00:00,경상남도,1628,877,830,798,49.02
2020-11-09 00:00:00,,1084,831,713,371,34.23
2020-11-09 00:00:00,충청북도,1341,815,713,628,46.83
2020-11-09 00:00:00,전라북도,1245,732,677,568,45.62
2020-11-09 00:00:00,부산광역시,1332,714,691,641,48.12
2020-11-09 00:00:00,전라남도,1236,713,667,569,46.04
2020-11-09 00:00:00,대전광역시,1066,607,544,522,48.97
2020-11-09 00:00:00,경기,767,548,430,337,43.94
2020-11-09 00:00:00,광주광역시,801,468,412,389,48.56
2020-11-09 00:00:00,대구광역시,825,459,413,412,49.94
2020-11-09 00:00:00,제주특별자치도,667,379,368,299,44.83
2020-11-09 00:00:00,울산광역시,422,245,222,200,47.39
2020-11-09 00:00:00,세종특별자치시,350,202,183,167,47.71
2020-11-09 00:00:00,인천광역,118,92,62,56,47.46
2020-11-09 00:00:00,인천,84,58,45,39,46.43
2020-11-09 00:00:00,충남,76,57,43,33,43.42
2020-11-09 00:00:00,강원,78,47,36,42,53.85
2020-11-09 00:00:00,경북,79,46,41,38,48.1
2020-11-09 00:00:00,경남,67,41,34,33,49.25
2020-11-09 00:00:00,충북,53,37,31,22,41.51
2020-11-09 00:00:00,전북,51,35,24,27,52.94
2020-11-09 00:00:00,대구광역,35,26,17,18,51.43
2020-11-09 00:00:00,부산,35,24,16,19,54.29
2020-11-09 00:00:00,부산광역,39,24,20,19,48.72
2020-11-09 00:00:00,전남,34,23,19,15,44.12
2020-11-09 00:00:00,대전광역,44,23,19,25,56.82
2020-11-09 00:00:00,광주,34,22,19,15,44.12
2020-11-09 00:00:00,★★★★★★★★,33,21,14,19,57.58
2020-11-09 00:00:00,대구,27,18,14,13,48.15
2020-11-09 00:00:00,광주광역,19,14,16,3,15.79
2020-11-09 00:00:00,대전,25,14,9,16,64
2020-11-09 00:00:00,제주도,17,12,10,7,41.18
2020-11-09 00:00:00,제주,18,11,9,9,50
2020-11-09 00:00:00,서울강북구,14,9,3,11,78.57
2020-11-09 00:00:00,울산광역,13,8,4,9,69.23
2020-11-09 00:00:00,울,8,7,6,2,25
2020-11-09 00:00:00,울산,10,5,2,8,80
2020-11-09 00:00:00,기,6,5,3,3,50
2020-11-09 00:00:00,서울시,3,3,2,1,33.33
2020-11-09 00:00:00,남,4,1,0,4,100
2020-11-09 00:00:00,전,1,1,1,0,0
2020-11-09 00:00:00,(주소불명)1119,1,1,0,1,100
2020-11-09 00:00:00,서울관악구봉천1동,1,1,1,0,0
2020-11-09 00:00:00,세종시,2,1,0,2,100
2020-11-09 00:00:00,원,1,1,1,0,0
2020-11-09 00:00:00,충부,2,1,0,2,100
2020-11-09 00:00:00,남동구만수2동,2,1,0,2,100
2020-11-09 00:00:00,경기도양주군회천읍,1,1,1,0,0
2020-11-16 00:00:00,서울특별시,48650,31060,27293,21357,43.9
2020-11-16 00:00:00,경기도,18383,11432,10111,8272,45
2020-11-16 00:00:00,인천광역시,3068,1881,1743,1325,43.19
2020-11-16 00:00:00,서울,2394,1710,1355,1039,43.4
2020-11-16 00:00:00,충청남도,2000,1227,1091,909,45.45
2020-11-16 00:00:00,경상북도,1921,1130,983,938,48.83
2020-11-16 00:00:00,강원도,1700,984,878,822,48.35
2020-11-16 00:00:00,경상남도,1531,859,802,729,47.62
2020-11-16 00:00:00,충청북도,1370,819,751,619,45.18
2020-11-16 00:00:00,,974,756,650,324,33.26
2020-11-16 00:00:00,전라북도,1278,729,639,639,50
2020-11-16 00:00:00,전라남도,1230,703,649,581,47.24
2020-11-16 00:00:00,부산광역시,1302,691,650,652,50.08
2020-11-16 00:00:00,대전광역시,1147,649,638,509,44.38
2020-11-16 00:00:00,경기,784,523,404,380,48.47
2020-11-16 00:00:00,대구광역시,891,514,457,434,48.71
2020-11-16 00:00:00,광주광역시,787,454,391,396,50.32
2020-11-16 00:00:00,제주특별자치도,723,375,383,340,47.03
2020-11-16 00:00:00,울산광역시,603,334,327,276,45.77
2020-11-16 00:00:00,세종특별자치시,367,217,191,176,47.96
2020-11-16 00:00:00,인천광역,131,89,71,60,45.8
2020-11-16 00:00:00,인천,90,64,44,46,51.11
2020-11-16 00:00:00,충남,87,60,44,43,49.43
2020-11-16 00:00:00,경북,79,56,40,39,49.37
2020-11-16 00:00:00,충북,68,47,34,34,50
2020-11-16 00:00:00,강원,66,43,31,35,53.03
2020-11-16 00:00:00,경남,48,35,25,23,47.92
2020-11-16 00:00:00,부산광역,39,29,24,15,38.46
2020-11-16 00:00:00,전북,55,29,24,31,56.36
2020-11-16 00:00:00,전남,56,27,21,35,62.5
2020-11-16 00:00:00,광주,35,25,23,12,34.29
2020-11-16 00:00:00,대전,38,24,21,17,44.74
2020-11-16 00:00:00,부산,38,21,12,26,68.42
2020-11-16 00:00:00,★★★★★★★★,30,18,9,21,70
2020-11-16 00:00:00,대전광역,28,18,11,17,60.71
2020-11-16 00:00:00,대구광역,25,15,11,14,56
2020-11-16 00:00:00,광주광역,15,13,12,3,20
2020-11-16 00:00:00,울산,24,12,15,9,37.5
2020-11-16 00:00:00,제주도,22,12,12,10,45.45
2020-11-16 00:00:00,대구,16,11,6,10,62.5
2020-11-16 00:00:00,서울강북구,14,10,10,4,28.57
2020-11-16 00:00:00,울산광역,17,10,6,11,64.71
2020-11-16 00:00:00,제주,11,10,7,4,36.36
2020-11-16 00:00:00,울,8,5,3,5,62.5
2020-11-16 00:00:00,기,5,4,3,2,40
2020-11-16 00:00:00,서울시,3,2,1,2,66.67
2020-11-16 00:00:00,남,4,2,2,2,50
2020-11-16 00:00:00,부산시,1,1,1,0,0
2020-11-16 00:00:00,인천직할시,2,1,1,1,50
2020-11-16 00:00:00,산,2,1,2,0,0
2020-11-16 00:00:00,남동구만수2동,2,1,0,2,100
2020-11-16 00:00:00,충부,2,1,2,0,0
2020-11-16 00:00:00,주,1,1,1,0,0
2020-11-16 00:00:00,강북구,1,1,1,0,0
2020-11-16 00:00:00,전남여수시여서동,2,1,1,1,50
2020-11-23 00:00:00,서울특별시,49028,31048,27466,21562,43.98
2020-11-23 00:00:00,경기도,18380,11455,10159,8221,44.73
2020-11-23 00:00:00,인천광역시,3141,1868,1697,1444,45.97
2020-11-23 00:00:00,서울,2298,1625,1283,1015,44.17
2020-11-23 00:00:00,충청남도,2168,1305,1186,982,45.3
2020-11-23 00:00:00,경상북도,2006,1154,1048,958,47.76
2020-11-23 00:00:00,강원도,1753,1048,962,791,45.12
2020-11-23 00:00:00,경상남도,1530,881,768,762,49.8
2020-11-23 00:00:00,충청북도,1374,802,756,618,44.98
2020-11-23 00:00:00,,952,775,691,261,27.42
2020-11-23 00:00:00,전라북도,1321,738,707,614,46.48
2020-11-23 00:00:00,전라남도,1295,729,649,646,49.88
2020-11-23 00:00:00,부산광역시,1254,661,630,624,49.76
2020-11-23 00:00:00,대전광역시,1178,642,645,533,45.25
2020-11-23 00:00:00,대구광역시,951,534,511,440,46.27
2020-11-23 00:00:00,경기,754,514,421,333,44.16
2020-11-23 00:00:00,광주광역시,844,459,448,396,46.92
2020-11-23 00:00:00,제주특별자치도,594,328,324,270,45.45
2020-11-23 00:00:00,울산광역시,475,268,259,216,45.47
2020-11-23 00:00:00,세종특별자치시,345,202,194,151,43.77
2020-11-23 00:00:00,인천광역,124,92,72,52,41.94
2020-11-23 00:00:00,인천,109,75,72,37,33.94
2020-11-23 00:00:00,충남,100,65,44,56,56
2020-11-23 00:00:00,강원,66,50,39,27,40.91
2020-11-23 00:00:00,경북,70,46,37,33,47.14
2020-11-23 00:00:00,전북,56,36,41,15,26.79
2020-11-23 00:00:00,충북,47,34,19,28,59.57
2020-11-23 00:00:00,대전광역,38,29,19,19,50
2020-11-23 00:00:00,전남,47,29,31,16,34.04
2020-11-23 00:00:00,경남,43,24,16,27,62.79
2020-11-23 00:00:00,광주광역,29,22,23,6,20.69
2020-11-23 00:00:00,부산광역,32,21,15,17,53.13
2020-11-23 00:00:00,대구광역,32,20,14,18,56.25
2020-11-23 00:00:00,대전,26,20,13,13,50
2020-11-23 00:00:00,부산,28,19,16,12,42.86
2020-11-23 00:00:00,광주,24,18,13,11,45.83
2020-11-23 00:00:00,★★★★★★★★,18,14,6,12,66.67
2020-11-23 00:00:00,제주도,21,11,9,12,57.14
2020-11-23 00:00:00,울산광역,16,11,13,3,18.75
2020-11-23 00:00:00,서울강북구,12,10,9,3,25
2020-11-23 00:00:00,울산,21,10,6,15,71.43
2020-11-23 00:00:00,대구,10,9,7,3,30
2020-11-23 00:00:00,울,9,7,4,5,55.56
2020-11-23 00:00:00,기,6,6,5,1,16.67
2020-11-23 00:00:00,제주,6,6,5,1,16.67
2020-11-23 00:00:00,서울시,2,2,1,1,50
2020-11-23 00:00:00,남동구만수2동,2,2,2,0,0
2020-11-23 00:00:00,인천직할시,1,1,1,0,0
2020-11-23 00:00:00,산,2,1,0,2,100
2020-11-23 00:00:00,서대문구,1,1,0,1,100
2020-11-23 00:00:00,서울관악구봉천1동,1,1,1,0,0
2020-11-30 00:00:00,서울특별시,49108,31169,27575,21533,43.85
2020-11-30 00:00:00,경기도,17889,11185,10010,7879,44.04
2020-11-30 00:00:00,인천광역시,3073,1827,1676,1397,45.46
2020-11-30 00:00:00,서울,2343,1701,1375,968,41.31
2020-11-30 00:00:00,충청남도,2087,1277,1168,919,44.03
2020-11-30 00:00:00,경상북도,1860,1051,991,869,46.72
2020-11-30 00:00:00,강원도,1721,980,943,778,45.21
2020-11-30 00:00:00,,1177,877,779,398,33.81
2020-11-30 00:00:00,경상남도,1531,819,778,753,49.18
2020-11-30 00:00:00,충청북도,1295,759,686,609,47.03
2020-11-30 00:00:00,전라남도,1199,690,606,593,49.46
2020-11-30 00:00:00,전라북도,1191,659,609,582,48.87
2020-11-30 00:00:00,대전광역시,1054,604,549,505,47.91
2020-11-30 00:00:00,부산광역시,1130,597,529,601,53.19
2020-11-30 00:00:00,경기,765,529,419,346,45.23
2020-11-30 00:00:00,대구광역시,840,490,478,362,43.1
2020-11-30 00:00:00,광주광역시,800,406,405,395,49.38
2020-11-30 00:00:00,제주특별자치도,603,311,314,289,47.93
2020-11-30 00:00:00,울산광역시,436,253,233,203,46.56
2020-11-30 00:00:00,세종특별자치시,364,219,180,184,50.55
2020-11-30 00:00:00,인천광역,108,79,65,43,39.81
2020-11-30 00:00:00,인천,85,67,61,24,28.24
2020-11-30 00:00:00,충남,67,51,41,26,38.81
2020-11-30 00:00:00,경북,83,48,41,42,50.6
2020-11-30 00:00:00,충북,51,35,30,21,41.18
2020-11-30 00:00:00,경남,59,34,32,27,45.76
2020-11-30 00:00:00,강원,50,32,24,26,52
2020-11-30 00:00:00,광주광역,38,25,24,14,36.84
2020-11-30 00:00:00,부산광역,34,22,14,20,58.82
2020-11-30 00:00:00,부산,38,21,22,16,42.11
2020-11-30 00:00:00,전북,36,21,22,14,38.89
2020-11-30 00:00:00,대전,30,20,14,16,53.33
2020-11-30 00:00:00,전남,30,18,18,12,40
2020-11-30 00:00:00,★★★★★★★★,28,18,10,18,64.29
2020-11-30 00:00:00,대전광역,24,17,14,10,41.67
2020-11-30 00:00:00,광주,22,16,12,10,45.45
2020-11-30 00:00:00,울산,29,14,14,15,51.72
2020-11-30 00:00:00,울,8,8,8,0,0
2020-11-30 00:00:00,대구,12,8,6,6,50
2020-11-30 00:00:00,대구광역,9,8,6,3,33.33
2020-11-30 00:00:00,제주,12,7,8,4,33.33
2020-11-30 00:00:00,서울강북구,10,7,5,5,50
2020-11-30 00:00:00,울산광역,10,7,5,5,50
2020-11-30 00:00:00,제주도,13,6,4,9,69.23
2020-11-30 00:00:00,남,6,4,4,2,33.33
2020-11-30 00:00:00,기,3,2,1,2,66.67
2020-11-30 00:00:00,세종시,1,1,1,0,0
2020-11-30 00:00:00,서울시,1,1,0,1,100
2020-11-30 00:00:00,경기도화성시송산동,2,1,1,1,50
2020-11-30 00:00:00,서구,2,1,1,1,50
2020-12-07 00:00:00,서울특별시,50057,31569,27987,22070,44.09
2020-12-07 00:00:00,경기도,18427,11520,10182,8245,44.74
2020-12-07 00:00:00,인천광역시,3159,1871,1781,1378,43.62
2020-12-07 00:00:00,서울,2538,1793,1456,1082,42.63
2020-12-07 00:00:00,충청남도,2137,1280,1163,974,45.58
2020-12-07 00:00:00,경상북도,1977,1104,979,998,50.48
2020-12-07 00:00:00,강원도,1771,1028,944,827,46.7
2020-12-07 00:00:00,경상남도,1511,836,750,761,50.36
2020-12-07 00:00:00,,994,753,628,366,36.82
2020-12-07 00:00:00,충청북도,1293,752,735,558,43.16
2020-12-07 00:00:00,전라남도,1200,698,617,583,48.58
2020-12-07 00:00:00,부산광역시,1191,647,629,562,47.19
2020-12-07 00:00:00,전라북도,1113,646,570,543,48.79
2020-12-07 00:00:00,대전광역시,1145,634,618,527,46.03
2020-12-07 00:00:00,경기,811,570,433,378,46.61
2020-12-07 00:00:00,대구광역시,818,459,402,416,50.86
2020-12-07 00:00:00,광주광역시,801,433,405,396,49.44
2020-12-07 00:00:00,제주특별자치도,597,341,322,275,46.06
2020-12-07 00:00:00,울산광역시,438,269,232,206,47.03
2020-12-07 00:00:00,세종특별자치시,364,221,196,168,46.15
2020-12-07 00:00:00,인천광역,120,87,57,63,52.5
2020-12-07 00:00:00,충남,83,56,44,39,46.99
2020-12-07 00:00:00,인천,75,55,46,29,38.67
2020-12-07 00:00:00,경북,81,51,38,43,53.09
2020-12-07 00:00:00,경남,59,39,27,32,54.24
2020-12-07 00:00:00,충북,64,37,28,36,56.25
2020-12-07 00:00:00,강원,46,37,23,23,50
2020-12-07 00:00:00,전북,44,28,20,24,54.55
2020-12-07 00:00:00,부산광역,36,26,19,17,47.22
2020-12-07 00:00:00,광주광역,41,25,18,23,56.1
2020-12-07 00:00:00,★★★★★★★★,33,25,17,16,48.48
2020-12-07 00:00:00,대전,29,23,12,17,58.62
2020-12-07 00:00:00,전남,32,21,20,12,37.5
2020-12-07 00:00:00,대전광역,30,21,18,12,40
2020-12-07 00:00:00,광주,26,15,15,11,42.31
2020-12-07 00:00:00,부산,22,15,12,10,45.45
2020-12-07 00:00:00,대구,18,13,10,8,44.44
2020-12-07 00:00:00,대구광역,14,11,6,8,57.14
2020-12-07 00:00:00,울,13,10,7,6,46.15
2020-12-07 00:00:00,울산,17,9,5,12,70.59
2020-12-07 00:00:00,제주도,10,8,7,3,30
2020-12-07 00:00:00,서울강북구,7,6,6,1,14.29
2020-12-07 00:00:00,제주,7,4,6,1,14.29
2020-12-07 00:00:00,기,5,4,1,4,80
2020-12-07 00:00:00,울산광역,4,3,1,3,75
2020-12-07 00:00:00,서울시,4,3,1,3,75
2020-12-07 00:00:00,경기도화성시송산동,1,1,1,0,0
2020-12-07 00:00:00,서초구,1,1,1,0,0
2020-12-07 00:00:00,서울관악구봉천1동,1,1,1,0,0
2020-12-07 00:00:00,광주시,2,1,0,2,100
2020-12-07 00:00:00,대정광역,1,1,1,0,0
2020-12-07 00:00:00,북,2,1,0,2,100
2020-12-14 00:00:00,서울특별시,50499,30978,28670,21829,43.23
2020-12-14 00:00:00,경기도,18523,11387,10084,8439,45.56
2020-12-14 00:00:00,인천광역시,3041,1853,1698,1343,44.16
2020-12-14 00:00:00,서울,2264,1635,1298,966,42.67
2020-12-14 00:00:00,충청남도,2204,1328,1201,1003,45.51
2020-12-14 00:00:00,경상북도,1889,1068,930,959,50.77
2020-12-14 00:00:00,강원도,1743,1000,901,842,48.31
2020-12-14 00:00:00,경상남도,1593,819,777,816,51.22
2020-12-14 00:00:00,충청북도,1413,790,787,626,44.3
2020-12-14 00:00:00,,951,738,650,301,31.65
2020-12-14 00:00:00,전라남도,1310,702,661,649,49.54
2020-12-14 00:00:00,전라북도,1222,673,616,606,49.59
2020-12-14 00:00:00,대전광역시,1154,641,575,579,50.17
2020-12-14 00:00:00,부산광역시,1197,625,620,577,48.2
2020-12-14 00:00:00,경기,746,525,400,346,46.38
2020-12-14 00:00:00,대구광역시,867,477,429,438,50.52
2020-12-14 00:00:00,광주광역시,809,456,414,395,48.83
2020-12-14 00:00:00,제주특별자치도,622,323,325,297,47.75
2020-12-14 00:00:00,울산광역시,379,204,213,166,43.8
2020-12-14 00:00:00,세종특별자치시,338,191,159,179,52.96
2020-12-14 00:00:00,인천광역,96,70,60,36,37.5
2020-12-14 00:00:00,인천,106,67,53,53,50
2020-12-14 00:00:00,충남,80,56,43,37,46.25
2020-12-14 00:00:00,경북,68,44,32,36,52.94
2020-12-14 00:00:00,충북,57,38,28,29,50.88
2020-12-14 00:00:00,강원,66,35,24,42,63.64
2020-12-14 00:00:00,경남,56,32,20,36,64.29
2020-12-14 00:00:00,대전광역,34,24,19,15,44.12
2020-12-14 00:00:00,부산광역,33,23,15,18,54.55
2020-12-14 00:00:00,전북,35,23,17,18,51.43
2020-12-14 00:00:00,광주광역,31,22,19,12,38.71
2020-12-14 00:00:00,대전,24,17,8,16,66.67
2020-12-14 00:00:00,부산,32,17,13,19,59.38
2020-12-14 00:00:00,광주,29,17,11,18,62.07
2020-12-14 00:00:00,★★★★★★★★,20,16,5,15,75
2020-12-14 00:00:00,대구광역,23,15,11,12,52.17
2020-12-14 00:00:00,전남,29,13,17,12,41.38
2020-12-14 00:00:00,울산,9,9,6,3,33.33
2020-12-14 00:00:00,울,14,9,6,8,57.14
2020-12-14 00:00:00,서울강북구,10,7,5,5,50
2020-12-14 00:00:00,울산광역,10,7,1,9,90
2020-12-14 00:00:00,대구,14,7,5,9,64.29
2020-12-14 00:00:00,제주도,9,6,2,7,77.78
2020-12-14 00:00:00,제주,10,4,1,9,90
2020-12-14 00:00:00,남,6,3,4,2,33.33
2020-12-14 00:00:00,서울시,2,2,1,1,50
2020-12-14 00:00:00,기,2,2,2,0,0
2020-12-14 00:00:00,산,4,2,4,0,0
2020-12-14 00:00:00,경기도화성시송산동,1,1,1,0,0
2020-12-14 00:00:00,전,2,1,0,2,100
2020-12-14 00:00:00,강서구,1,1,1,0,0
2020-12-14 00:00:00,경기의왕시포일동,1,1,1,0,0
2020-12-14 00:00:00,원주시,1,1,0,1,100
2020-12-14 00:00:00,대동@,2,1,1,1,50
2020-12-14 00:00:00,광주시,1,1,1,0,0
2020-12-21 00:00:00,서울특별시,41909,26516,24035,17874,42.65
2020-12-21 00:00:00,경기도,14988,9464,8445,6543,43.65
2020-12-21 00:00:00,인천광역시,2514,1496,1381,1133,45.07
2020-12-21 00:00:00,서울,1879,1358,1120,759,40.39
2020-12-21 00:00:00,충청남도,1712,1058,935,777,45.39
2020-12-21 00:00:00,경상북도,1612,901,864,748,46.4
2020-12-21 00:00:00,강원도,1362,800,734,628,46.11
2020-12-21 00:00:00,경상남도,1215,685,616,599,49.3
2020-12-21 00:00:00,충청북도,1113,656,630,483,43.4
2020-12-21 00:00:00,,834,647,526,308,36.93
2020-12-21 00:00:00,전라남도,1018,598,516,502,49.31
2020-12-21 00:00:00,부산광역시,978,538,485,493,50.41
2020-12-21 00:00:00,대전광역시,887,537,471,416,46.9
2020-12-21 00:00:00,전라북도,957,534,475,482,50.37
2020-12-21 00:00:00,경기,652,459,366,286,43.87
2020-12-21 00:00:00,대구광역시,655,373,339,316,48.24
2020-12-21 00:00:00,광주광역시,646,367,320,326,50.46
2020-12-21 00:00:00,제주특별자치도,511,254,243,268,52.45
2020-12-21 00:00:00,울산광역시,377,212,192,185,49.07
2020-12-21 00:00:00,세종특별자치시,270,167,150,120,44.44
2020-12-21 00:00:00,인천,68,56,45,23,33.82
2020-12-21 00:00:00,인천광역,83,56,38,45,54.22
2020-12-21 00:00:00,충남,85,55,49,36,42.35
2020-12-21 00:00:00,강원,48,35,27,21,43.75
2020-12-21 00:00:00,경남,46,32,25,21,45.65
2020-12-21 00:00:00,경북,45,31,23,22,48.89
2020-12-21 00:00:00,★★★★★★★★,30,25,14,16,53.33
2020-12-21 00:00:00,충북,27,21,17,10,37.04
2020-12-21 00:00:00,광주,30,19,15,15,50
2020-12-21 00:00:00,부산광역,29,18,15,14,48.28
2020-12-21 00:00:00,대전,22,16,7,15,68.18
2020-12-21 00:00:00,전북,21,15,10,11,52.38
2020-12-21 00:00:00,전남,29,15,12,17,58.62
2020-12-21 00:00:00,광주광역,17,15,11,6,35.29
2020-12-21 00:00:00,대구,18,14,10,8,44.44
2020-12-21 00:00:00,대전광역,19,13,10,9,47.37
2020-12-21 00:00:00,부산,19,13,8,11,57.89
2020-12-21 00:00:00,대구광역,14,10,7,7,50
2020-12-21 00:00:00,울산광역,11,8,7,4,36.36
2020-12-21 00:00:00,울산,10,7,2,8,80
2020-12-21 00:00:00,제주,12,7,6,6,50
2020-12-21 00:00:00,서울강북구,6,5,4,2,33.33
2020-12-21 00:00:00,울,7,5,4,3,42.86
2020-12-21 00:00:00,제주도,5,4,2,3,60
2020-12-21 00:00:00,남,3,2,2,1,33.33
2020-12-21 00:00:00,기,2,2,2,0,0
2020-12-21 00:00:00,서울시,4,2,2,2,50
2020-12-21 00:00:00,강북구,3,1,2,1,33.33
2020-12-21 00:00:00,경기용인시풍덕천2동,1,1,1,0,0
2020-12-21 00:00:00,전,1,1,1,0,0
2020-12-21 00:00:00,산,2,1,1,1,50
2020-12-21 00:00:00,대동@,3,1,1,2,66.67
2020-12-21 00:00:00,부산시,1,1,1,0,0
2020-12-28 00:00:00,서울특별시,38936,24433,21143,17793,45.7
2020-12-28 00:00:00,경기도,14190,8909,7541,6649,46.86
2020-12-28 00:00:00,인천광역시,2323,1411,1234,1089,46.88
2020-12-28 00:00:00,서울,1663,1181,905,758,45.58
2020-12-28 00:00:00,충청남도,1541,956,808,733,47.57
2020-12-28 00:00:00,경상북도,1388,797,679,709,51.08
2020-12-28 00:00:00,강원도,1282,762,635,647,50.47
2020-12-28 00:00:00,충청북도,1130,629,540,590,52.21
2020-12-28 00:00:00,,785,622,567,218,27.77
2020-12-28 00:00:00,경상남도,1068,616,506,562,52.62
2020-12-28 00:00:00,전라남도,893,511,403,490,54.87
2020-12-28 00:00:00,전라북도,853,510,438,415,48.65
2020-12-28 00:00:00,부산광역시,901,491,406,495,54.94
2020-12-28 00:00:00,대전광역시,732,441,383,349,47.68
2020-12-28 00:00:00,경기,551,383,293,258,46.82
2020-12-28 00:00:00,광주광역시,637,348,295,342,53.69
2020-12-28 00:00:00,대구광역시,587,335,265,322,54.86
2020-12-28 00:00:00,제주특별자치도,452,238,197,255,56.42
2020-12-28 00:00:00,울산광역시,315,179,142,173,54.92
2020-12-28 00:00:00,세종특별자치시,254,153,126,128,50.39
2020-12-28 00:00:00,인천광역,72,52,44,28,38.89
2020-12-28 00:00:00,충남,54,38,20,34,62.96
2020-12-28 00:00:00,인천,50,37,26,24,48
2020-12-28 00:00:00,경남,47,27,19,28,59.57
2020-12-28 00:00:00,대전광역,29,23,15,14,48.28
2020-12-28 00:00:00,경북,29,20,13,16,55.17
2020-12-28 00:00:00,강원,32,19,12,20,62.5
2020-12-28 00:00:00,충북,24,17,8,16,66.67
2020-12-28 00:00:00,전북,31,16,11,20,64.52
2020-12-28 00:00:00,부산광역,23,16,12,11,47.83
2020-12-28 00:00:00,★★★★★★★★,18,16,7,11,61.11
2020-12-28 00:00:00,대전,22,14,10,12,54.55
2020-12-28 00:00:00,광주광역,23,14,9,14,60.87
2020-12-28 00:00:00,광주,20,13,9,11,55
2020-12-28 00:00:00,전남,30,12,15,15,50
2020-12-28 00:00:00,대구,19,11,5,14,73.68
2020-12-28 00:00:00,대구광역,16,10,9,7,43.75
2020-12-28 00:00:00,부산,12,10,6,6,50
2020-12-28 00:00:00,서울강북구,10,8,6,4,40
2020-12-28 00:00:00,울,7,7,6,1,14.29
2020-12-28 00:00:00,울산광역,9,7,4,5,55.56
2020-12-28 00:00:00,울산,13,7,5,8,61.54
2020-12-28 00:00:00,기,9,6,3,6,66.67
2020-12-28 00:00:00,제주,14,6,5,9,64.29
2020-12-28 00:00:00,제주도,5,5,2,3,60
2020-12-28 00:00:00,남,3,2,0,3,100
2020-12-28 00:00:00,서울시,3,2,1,2,66.67
2020-12-28 00:00:00,북,1,1,1,0,0
2020-12-28 00:00:00,천,1,1,1,0,0
2020-12-28 00:00:00,대동@,1,1,1,0,0
2020-12-28 00:00:00,강북구,1,1,1,0,0
2020-12-28 00:00:00,산,3,1,2,1,33.33
2021-01-04 00:00:00,서울특별시,50072,30967,27418,22654,45.24
2021-01-04 00:00:00,경기도,18010,11112,9736,8274,45.94
2021-01-04 00:00:00,인천광역시,2989,1776,1622,1367,45.73
2021-01-04 00:00:00,서울,2389,1668,1294,1095,45.84
2021-01-04 00:00:00,충청남도,2077,1236,1094,983,47.33
2021-01-04 00:00:00,강원도,1759,1050,903,856,48.66
2021-01-04 00:00:00,경상북도,1788,993,884,904,50.56
2021-01-04 00:00:00,경상남도,1575,844,776,799,50.73
2021-01-04 00:00:00,,1056,807,656,400,37.88
2021-01-04 00:00:00,충청북도,1393,781,739,654,46.95
2021-01-04 00:00:00,전라북도,1218,685,602,616,50.57
2021-01-04 00:00:00,전라남도,1190,669,591,599,50.34
2021-01-04 00:00:00,부산광역시,1247,647,630,617,49.48
2021-01-04 00:00:00,대전광역시,1112,614,534,578,51.98
2021-01-04 00:00:00,경기,830,565,413,417,50.24
2021-01-04 00:00:00,대구광역시,799,461,394,405,50.69
2021-01-04 00:00:00,광주광역시,863,442,419,444,51.45
2021-01-04 00:00:00,울산광역시,546,295,265,281,51.47
2021-01-04 00:00:00,제주특별자치도,568,285,242,326,57.39
2021-01-04 00:00:00,세종특별자치시,373,214,189,184,49.33
2021-01-04 00:00:00,인천광역,117,81,61,56,47.86
2021-01-04 00:00:00,인천,85,56,44,41,48.24
2021-01-04 00:00:00,충남,63,42,33,30,47.62
2021-01-04 00:00:00,강원,72,39,23,49,68.06
2021-01-04 00:00:00,경북,58,36,30,28,48.28
2021-01-04 00:00:00,전북,53,31,20,33,62.26
2021-01-04 00:00:00,광주광역,36,26,15,21,58.33
2021-01-04 00:00:00,충북,38,25,14,24,63.16
2021-01-04 00:00:00,경남,37,25,17,20,54.05
2021-01-04 00:00:00,부산광역,38,23,18,20,52.63
2021-01-04 00:00:00,대전,29,18,16,13,44.83
2021-01-04 00:00:00,대전광역,32,18,16,16,50
2021-01-04 00:00:00,광주,22,18,15,7,31.82
2021-01-04 00:00:00,전남,29,17,15,14,48.28
2021-01-04 00:00:00,부산,20,15,12,8,40
2021-01-04 00:00:00,대구,18,14,10,8,44.44
2021-01-04 00:00:00,대구광역,17,12,8,9,52.94
2021-01-04 00:00:00,제주도,19,12,5,14,73.68
2021-01-04 00:00:00,울산광역,15,12,9,6,40
2021-01-04 00:00:00,★★★★★★★★,15,11,10,5,33.33
2021-01-04 00:00:00,서울강북구,20,10,9,11,55
2021-01-04 00:00:00,제주,17,9,5,12,70.59
2021-01-04 00:00:00,울,9,9,6,3,33.33
2021-01-04 00:00:00,울산,12,7,7,5,41.67
2021-01-04 00:00:00,기,3,3,3,0,0
2021-01-04 00:00:00,남,4,3,3,1,25
2021-01-04 00:00:00,원,1,1,0,1,100
2021-01-04 00:00:00,서울시,1,1,0,1,100
2021-01-04 00:00:00,경기용인시풍덕천2동,2,1,1,1,50
2021-01-04 00:00:00,강북구,1,1,1,0,0
2021-01-11 00:00:00,서울특별시,49191,30786,27635,21556,43.82
2021-01-11 00:00:00,경기도,18136,11155,9892,8244,45.46
2021-01-11 00:00:00,인천광역시,3198,1855,1721,1477,46.19
2021-01-11 00:00:00,서울,2410,1656,1368,1042,43.24
2021-01-11 00:00:00,충청남도,2192,1304,1224,968,44.16
2021-01-11 00:00:00,경상북도,1896,1063,965,931,49.1
2021-01-11 00:00:00,강원도,1761,1014,933,828,47.02
2021-01-11 00:00:00,경상남도,1598,869,787,811,50.75
2021-01-11 00:00:00,충청북도,1402,813,761,641,45.72
2021-01-11 00:00:00,,1017,783,665,352,34.61
2021-01-11 00:00:00,전라북도,1289,714,641,648,50.27
2021-01-11 00:00:00,전라남도,1302,711,622,680,52.23
2021-01-11 00:00:00,부산광역시,1291,668,654,637,49.34
2021-01-11 00:00:00,대전광역시,1137,646,624,513,45.12
2021-01-11 00:00:00,경기,855,570,466,389,45.5
2021-01-11 00:00:00,광주광역시,824,487,439,385,46.72
2021-01-11 00:00:00,대구광역시,842,476,452,390,46.32
2021-01-11 00:00:00,제주특별자치도,735,377,390,345,46.94
2021-01-11 00:00:00,울산광역시,468,269,222,246,52.56
2021-01-11 00:00:00,세종특별자치시,360,215,197,163,45.28
2021-01-11 00:00:00,인천광역,144,94,79,65,45.14
2021-01-11 00:00:00,인천,101,74,60,41,40.59
2021-01-11 00:00:00,강원,77,50,49,28,36.36
2021-01-11 00:00:00,경북,83,50,37,46,55.42
2021-01-11 00:00:00,충남,77,48,42,35,45.45
2021-01-11 00:00:00,경남,63,40,31,32,50.79
2021-01-11 00:00:00,충북,49,33,24,25,51.02
2021-01-11 00:00:00,전북,48,32,26,22,45.83
2021-01-11 00:00:00,부산광역,37,25,16,21,56.76
2021-01-11 00:00:00,광주,40,24,16,24,60
2021-01-11 00:00:00,대전광역,32,24,20,12,37.5
2021-01-11 00:00:00,전남,38,23,17,21,55.26
2021-01-11 00:00:00,광주광역,26,21,18,8,30.77
2021-01-11 00:00:00,대전,30,20,11,19,63.33
2021-01-11 00:00:00,대구광역,19,14,11,8,42.11
2021-01-11 00:00:00,★★★★★★★★,16,11,8,8,50
2021-01-11 00:00:00,울산광역,16,11,8,8,50
2021-01-11 00:00:00,부산,17,10,5,12,70.59
2021-01-11 00:00:00,제주,19,9,6,13,68.42
2021-01-11 00:00:00,대구,13,9,7,6,46.15
2021-01-11 00:00:00,제주도,16,8,8,8,50
2021-01-11 00:00:00,울산,11,7,5,6,54.55
2021-01-11 00:00:00,울,8,6,5,3,37.5
2021-01-11 00:00:00,서울강북구,9,6,3,6,66.67
2021-01-11 00:00:00,서울관악구봉천1동,3,3,2,1,33.33
2021-01-11 00:00:00,기,4,3,2,2,50
2021-01-11 00:00:00,북,2,1,1,1,50
2021-01-11 00:00:00,남,1,1,1,0,0
2021-01-11 00:00:00,대동@,1,1,1,0,0
2021-01-11 00:00:00,광진구,1,1,0,1,100
2021-01-11 00:00:00,산,2,1,2,0,0
2021-01-11 00:00:00,서울시,5,1,1,4,80
2021-01-11 00:00:00,강북구,1,1,1,0,0
2021-01-18 00:00:00,서울특별시,50093,31277,28025,22068,44.05
2021-01-18 00:00:00,경기도,18568,11493,10328,8240,44.38
2021-01-18 00:00:00,인천광역시,3201,1841,1783,1418,44.3
2021-01-18 00:00:00,서울,2452,1737,1395,1057,43.11
2021-01-18 00:00:00,충청남도,2130,1297,1162,968,45.45
2021-01-18 00:00:00,경상북도,1886,1085,997,889,47.14
2021-01-18 00:00:00,강원도,1887,1077,974,913,48.38
2021-01-18 00:00:00,경상남도,1549,886,770,779,50.29
2021-01-18 00:00:00,충청북도,1396,809,754,642,45.99
2021-01-18 00:00:00,,1010,774,647,363,35.94
2021-01-18 00:00:00,전라북도,1303,749,701,602,46.2
2021-01-18 00:00:00,전라남도,1313,721,650,663,50.5
2021-01-18 00:00:00,부산광역시,1371,697,675,696,50.77
2021-01-18 00:00:00,대전광역시,1139,635,590,549,48.2
2021-01-18 00:00:00,경기,765,539,469,296,38.69
2021-01-18 00:00:00,대구광역시,891,479,447,444,49.83
2021-01-18 00:00:00,광주광역시,854,467,451,403,47.19
2021-01-18 00:00:00,제주특별자치도,676,343,344,332,49.11
2021-01-18 00:00:00,울산광역시,484,252,250,234,48.35
2021-01-18 00:00:00,세종특별자치시,349,214,201,148,42.41
2021-01-18 00:00:00,인천광역,147,105,84,63,42.86
2021-01-18 00:00:00,인천,89,68,57,32,35.96
2021-01-18 00:00:00,충남,82,58,48,34,41.46
2021-01-18 00:00:00,경북,69,43,27,42,60.87
2021-01-18 00:00:00,경남,65,40,28,37,56.92
2021-01-18 00:00:00,충북,54,40,29,25,46.3
2021-01-18 00:00:00,강원,53,35,24,29,54.72
2021-01-18 00:00:00,전북,42,29,20,22,52.38
2021-01-18 00:00:00,대전광역,35,27,20,15,42.86
2021-01-18 00:00:00,전남,36,26,22,14,38.89
2021-01-18 00:00:00,광주,41,25,24,17,41.46
2021-01-18 00:00:00,부산광역,37,25,17,20,54.05
2021-01-18 00:00:00,광주광역,36,21,19,17,47.22
2021-01-18 00:00:00,대전,25,20,16,9,36
2021-01-18 00:00:00,부산,27,15,15,12,44.44
2021-01-18 00:00:00,대구광역,18,13,7,11,61.11
2021-01-18 00:00:00,울산,20,11,5,15,75
2021-01-18 00:00:00,서울강북구,14,10,8,6,42.86
2021-01-18 00:00:00,★★★★★★★★,15,10,4,11,73.33
2021-01-18 00:00:00,제주도,15,9,4,11,73.33
2021-01-18 00:00:00,제주,11,8,6,5,45.45
2021-01-18 00:00:00,대구,12,8,7,5,41.67
2021-01-18 00:00:00,울산광역,9,7,7,2,22.22
2021-01-18 00:00:00,울,5,5,4,1,20
2021-01-18 00:00:00,남,4,3,3,1,25
2021-01-18 00:00:00,기,6,3,0,6,100
2021-01-18 00:00:00,서울시,2,1,1,1,50
2021-01-18 00:00:00,강북구,1,1,0,1,100
2021-01-18 00:00:00,북,2,1,1,1,50
2021-01-18 00:00:00,서울관악구봉천1동,1,1,1,0,0
2021-01-18 00:00:00,천,6,1,1,5,83.33
2021-01-18 00:00:00,경기도화성시송산동,1,1,1,0,0
2021-01-18 00:00:00,산,3,1,2,1,33.33
2021-01-25 00:00:00,서울특별시,48395,30324,27113,21282,43.98
2021-01-25 00:00:00,경기도,17972,11103,9990,7982,44.41
2021-01-25 00:00:00,인천광역시,3162,1854,1717,1445,45.7
2021-01-25 00:00:00,서울,2313,1655,1315,998,43.15
2021-01-25 00:00:00,충청남도,2170,1287,1175,995,45.85
2021-01-25 00:00:00,강원도,1789,1077,999,790,44.16
2021-01-25 00:00:00,경상북도,1900,1046,974,926,48.74
2021-01-25 00:00:00,충청북도,1476,864,799,677,45.87
2021-01-25 00:00:00,경상남도,1612,848,769,843,52.3
2021-01-25 00:00:00,,946,724,628,318,33.62
2021-01-25 00:00:00,전라남도,1290,721,659,631,48.91
2021-01-25 00:00:00,전라북도,1312,721,654,658,50.15
2021-01-25 00:00:00,부산광역시,1230,668,635,595,48.37
2021-01-25 00:00:00,대전광역시,1130,655,566,564,49.91
2021-01-25 00:00:00,대구광역시,882,518,469,413,46.83
2021-01-25 00:00:00,경기,724,501,376,348,48.07
2021-01-25 00:00:00,광주광역시,836,447,434,402,48.09
2021-01-25 00:00:00,제주특별자치도,705,330,345,360,51.06
2021-01-25 00:00:00,울산광역시,499,269,248,251,50.3
2021-01-25 00:00:00,세종특별자치시,336,198,184,152,45.24
2021-01-25 00:00:00,인천광역,142,102,87,55,38.73
2021-01-25 00:00:00,인천,84,59,51,33,39.29
2021-01-25 00:00:00,충남,89,55,46,43,48.31
2021-01-25 00:00:00,경남,77,45,30,47,61.04
2021-01-25 00:00:00,경북,57,35,29,28,49.12
2021-01-25 00:00:00,충북,49,34,33,16,32.65
2021-01-25 00:00:00,강원,38,29,23,15,39.47
2021-01-25 00:00:00,부산광역,35,26,14,21,60
2021-01-25 00:00:00,전북,39,25,22,17,43.59
2021-01-25 00:00:00,광주광역,35,25,13,22,62.86
2021-01-25 00:00:00,대전광역,28,19,10,18,64.29
2021-01-25 00:00:00,대전,28,17,14,14,50
2021-01-25 00:00:00,전남,22,16,12,10,45.45
2021-01-25 00:00:00,부산,20,15,13,7,35
2021-01-25 00:00:00,광주,21,15,12,9,42.86
2021-01-25 00:00:00,★★★★★★★★,15,13,9,6,40
2021-01-25 00:00:00,대구광역,21,12,10,11,52.38
2021-01-25 00:00:00,울산,15,10,5,10,66.67
2021-01-25 00:00:00,대구,12,9,7,5,41.67
2021-01-25 00:00:00,기,9,7,4,5,55.56
2021-01-25 00:00:00,제주도,11,7,5,6,54.55
2021-01-25 00:00:00,서울강북구,8,7,6,2,25
2021-01-25 00:00:00,울산광역,9,7,5,4,44.44
2021-01-25 00:00:00,울,9,5,7,2,22.22
2021-01-25 00:00:00,서울시,3,3,2,1,33.33
2021-01-25 00:00:00,제주,3,2,0,3,100
2021-01-25 00:00:00,주,2,1,0,2,100
2021-01-25 00:00:00,강북구,1,1,0,1,100
2021-01-25 00:00:00,북,1,1,1,0,0
2021-01-25 00:00:00,인천시,1,1,0,1,100
2021-02-01 00:00:00,서울특별시,49450,31122,27787,21663,43.81
2021-02-01 00:00:00,경기도,18562,11531,10482,8080,43.53
2021-02-01 00:00:00,인천광역시,3098,1847,1748,1350,43.58
2021-02-01 00:00:00,서울,2316,1624,1362,954,41.19
2021-02-01 00:00:00,충청남도,2219,1311,1216,1003,45.2
2021-02-01 00:00:00,경상북도,1901,1070,978,923,48.55
2021-02-01 00:00:00,강원도,1784,1039,959,825,46.24
2021-02-01 00:00:00,경상남도,1591,872,795,796,50.03
2021-02-01 00:00:00,충청북도,1351,831,749,602,44.56
2021-02-01 00:00:00,전라북도,1359,753,704,655,48.2
2021-02-01 00:00:00,,945,727,645,300,31.75
2021-02-01 00:00:00,전라남도,1375,721,710,665,48.36
2021-02-01 00:00:00,부산광역시,1290,665,686,604,46.82
2021-02-01 00:00:00,대전광역시,1136,650,619,517,45.51
2021-02-01 00:00:00,경기,816,560,462,354,43.38
2021-02-01 00:00:00,대구광역시,837,479,472,365,43.61
2021-02-01 00:00:00,광주광역시,798,442,443,355,44.49
2021-02-01 00:00:00,제주특별자치도,701,381,383,318,45.36
2021-02-01 00:00:00,울산광역시,535,274,284,251,46.92
2021-02-01 00:00:00,세종특별자치시,322,201,188,134,41.61
2021-02-01 00:00:00,인천,137,85,72,65,47.45
2021-02-01 00:00:00,인천광역,109,83,70,39,35.78
2021-02-01 00:00:00,충남,81,58,49,32,39.51
2021-02-01 00:00:00,경북,53,38,32,21,39.62
2021-02-01 00:00:00,경남,52,32,29,23,44.23
2021-02-01 00:00:00,강원,44,31,25,19,43.18
2021-02-01 00:00:00,충북,40,29,22,18,45
2021-02-01 00:00:00,대전광역,33,28,22,11,33.33
2021-02-01 00:00:00,광주광역,35,25,18,17,48.57
2021-02-01 00:00:00,광주,39,23,22,17,43.59
2021-02-01 00:00:00,전북,28,21,19,9,32.14
2021-02-01 00:00:00,부산광역,23,19,12,11,47.83
2021-02-01 00:00:00,부산,23,17,12,11,47.83
2021-02-01 00:00:00,전남,31,17,15,16,51.61
2021-02-01 00:00:00,★★★★★★★★,21,16,8,13,61.9
2021-02-01 00:00:00,울산,18,13,12,6,33.33
2021-02-01 00:00:00,대전,13,12,10,3,23.08
2021-02-01 00:00:00,서울강북구,12,11,7,5,41.67
2021-02-01 00:00:00,울산광역,15,11,8,7,46.67
2021-02-01 00:00:00,대구광역,15,10,9,6,40
2021-02-01 00:00:00,제주도,16,9,5,11,68.75
2021-02-01 00:00:00,울,10,8,6,4,40
2021-02-01 00:00:00,대구,7,6,3,4,57.14
2021-02-01 00:00:00,제주,10,6,4,6,60
2021-02-01 00:00:00,기,7,5,6,1,14.29
2021-02-01 00:00:00,경기도화성시송산동,3,2,1,2,66.67
2021-02-01 00:00:00,광주시,1,1,1,0,0
2021-02-01 00:00:00,경기용인시풍덕천2동,1,1,1,0,0
2021-02-01 00:00:00,원,2,1,1,1,50
2021-02-01 00:00:00,강북구,1,1,1,0,0
2021-02-01 00:00:00,남,2,1,0,2,100
2021-02-01 00:00:00,인천시,1,1,1,0,0
2021-02-01 00:00:00,주,1,1,1,0,0
2021-02-01 00:00:00,서울시,1,1,0,1,100
2021-02-01 00:00:00,울주군,1,1,1,0,0
2021-02-08 00:00:00,서울특별시,32143,21415,18184,13959,43.43
2021-02-08 00:00:00,경기도,11841,7659,6710,5131,43.33
2021-02-08 00:00:00,인천광역시,2178,1291,1151,1027,47.15
2021-02-08 00:00:00,서울,1346,1030,800,546,40.56
2021-02-08 00:00:00,충청남도,1283,812,719,564,43.96
2021-02-08 00:00:00,강원도,1032,652,602,430,41.67
2021-02-08 00:00:00,경상북도,986,588,495,491,49.8
2021-02-08 00:00:00,,690,576,487,203,29.42
2021-02-08 00:00:00,충청북도,842,527,476,366,43.47
2021-02-08 00:00:00,경상남도,901,505,430,471,52.28
2021-02-08 00:00:00,전라북도,754,454,401,353,46.82
2021-02-08 00:00:00,전라남도,709,415,346,363,51.2
2021-02-08 00:00:00,부산광역시,698,389,367,331,47.42
2021-02-08 00:00:00,대전광역시,635,364,316,319,50.24
2021-02-08 00:00:00,경기,437,321,247,190,43.48
2021-02-08 00:00:00,대구광역시,478,302,228,250,52.3
2021-02-08 00:00:00,광주광역시,472,265,222,250,52.97
2021-02-08 00:00:00,제주특별자치도,401,230,221,180,44.89
2021-02-08 00:00:00,울산광역시,306,176,163,143,46.73
2021-02-08 00:00:00,세종특별자치시,192,119,111,81,42.19
2021-02-08 00:00:00,인천광역,86,62,51,35,40.7
2021-02-08 00:00:00,인천,67,50,40,27,40.3
2021-02-08 00:00:00,강원,36,28,19,17,47.22
2021-02-08 00:00:00,경북,37,27,19,18,48.65
2021-02-08 00:00:00,충남,29,24,16,13,44.83
2021-02-08 00:00:00,전북,25,17,12,13,52
2021-02-08 00:00:00,충북,18,16,14,4,22.22
2021-02-08 00:00:00,대전광역,23,15,11,12,52.17
2021-02-08 00:00:00,경남,24,15,10,14,58.33
2021-02-08 00:00:00,부산광역,22,13,8,14,63.64
2021-02-08 00:00:00,전남,14,12,11,3,21.43
2021-02-08 00:00:00,대구,22,12,7,15,68.18
2021-02-08 00:00:00,부산,14,10,7,7,50
2021-02-08 00:00:00,★★★★★★★★,12,9,6,6,50
2021-02-08 00:00:00,대전,16,9,6,10,62.5
2021-02-08 00:00:00,광주광역,11,9,7,4,36.36
2021-02-08 00:00:00,울,11,8,6,5,45.45
2021-02-08 00:00:00,서울강북구,8,7,5,3,37.5
2021-02-08 00:00:00,제주도,7,6,4,3,42.86
2021-02-08 00:00:00,광주,7,6,3,4,57.14
2021-02-08 00:00:00,울산,8,5,4,4,50
2021-02-08 00:00:00,대구광역,5,4,1,4,80
2021-02-08 00:00:00,울산광역,3,3,1,2,66.67
2021-02-08 00:00:00,기,6,2,0,6,100
2021-02-08 00:00:00,남,3,2,1,2,66.67
2021-02-08 00:00:00,산,2,1,2,0,0
2021-02-08 00:00:00,천,4,1,1,3,75
2021-02-08 00:00:00,제주,1,1,1,0,0
2021-02-08 00:00:00,서울시,3,1,0,3,100
2021-02-15 00:00:00,서울특별시,51997,32328,28887,23110,44.44
2021-02-15 00:00:00,경기도,19724,12059,10893,8831,44.77
2021-02-15 00:00:00,인천광역시,3474,2055,1892,1582,45.54
2021-02-15 00:00:00,서울,2348,1671,1328,1020,43.44
2021-02-15 00:00:00,충청남도,2359,1456,1330,1029,43.62
2021-02-15 00:00:00,경상북도,2162,1211,1170,992,45.88
2021-02-15 00:00:00,강원도,1965,1113,1073,892,45.39
2021-02-15 00:00:00,경상남도,1909,1031,958,951,49.82
2021-02-15 00:00:00,충청북도,1550,895,846,704,45.42
2021-02-15 00:00:00,전라남도,1477,844,745,732,49.56
2021-02-15 00:00:00,,1040,802,693,347,33.37
2021-02-15 00:00:00,전라북도,1456,795,747,709,48.7
2021-02-15 00:00:00,부산광역시,1325,716,688,637,48.08
2021-02-15 00:00:00,대전광역시,1202,700,680,522,43.43
2021-02-15 00:00:00,경기,840,580,449,391,46.55
2021-02-15 00:00:00,대구광역시,1023,546,487,536,52.39
2021-02-15 00:00:00,광주광역시,904,491,501,403,44.58
2021-02-15 00:00:00,제주특별자치도,767,383,396,371,48.37
2021-02-15 00:00:00,울산광역시,574,310,328,246,42.86
2021-02-15 00:00:00,세종특별자치시,393,236,197,196,49.87
2021-02-15 00:00:00,인천광역,136,99,80,56,41.18
2021-02-15 00:00:00,인천,97,71,56,41,42.27
2021-02-15 00:00:00,충남,63,48,40,23,36.51
2021-02-15 00:00:00,강원,70,44,31,39,55.71
2021-02-15 00:00:00,경남,76,43,32,44,57.89
2021-02-15 00:00:00,충북,63,41,28,35,55.56
2021-02-15 00:00:00,경북,60,40,29,31,51.67
2021-02-15 00:00:00,부산,48,31,24,24,50
2021-02-15 00:00:00,광주,45,31,20,25,55.56
2021-02-15 00:00:00,광주광역,29,26,22,7,24.14
2021-02-15 00:00:00,대전광역,35,23,18,17,48.57
2021-02-15 00:00:00,대전,32,21,12,20,62.5
2021-02-15 00:00:00,전북,30,20,19,11,36.67
2021-02-15 00:00:00,전남,38,20,16,22,57.89
2021-02-15 00:00:00,부산광역,39,20,21,18,46.15
2021-02-15 00:00:00,대구광역,26,16,11,15,57.69
2021-02-15 00:00:00,대구,20,16,13,7,35
2021-02-15 00:00:00,★★★★★★★★,24,16,10,14,58.33
2021-02-15 00:00:00,제주도,25,12,9,16,64
2021-02-15 00:00:00,제주,17,10,5,12,70.59
2021-02-15 00:00:00,울산광역,13,10,8,5,38.46
2021-02-15 00:00:00,서울강북구,14,10,9,5,35.71
2021-02-15 00:00:00,기,13,8,6,7,53.85
2021-02-15 00:00:00,울,12,8,4,8,66.67
2021-02-15 00:00:00,울산,10,7,2,8,80
2021-02-15 00:00:00,산,9,3,1,8,88.89
2021-02-15 00:00:00,서울시,7,3,2,5,71.43
2021-02-15 00:00:00,원주시,2,2,2,0,0
2021-02-15 00:00:00,광주시,2,1,1,1,50
2021-02-15 00:00:00,남,1,1,1,0,0
2021-02-15 00:00:00,서울관악구봉천1동,1,1,1,0,0
2021-02-15 00:00:00,경기도화성시송산동,1,1,1,0,0
2021-02-15 00:00:00,기도,1,1,1,0,0
2021-02-15 00:00:00,천,1,1,1,0,0
2021-02-22 00:00:00,서울특별시,50923,31697,28615,22308,43.81
2021-02-22 00:00:00,경기도,18964,11711,10726,8238,43.44
2021-02-22 00:00:00,인천광역시,3197,1875,1799,1398,43.73
2021-02-22 00:00:00,서울,2297,1612,1324,973,42.36
2021-02-22 00:00:00,충청남도,2333,1355,1293,1040,44.58
2021-02-22 00:00:00,경상북도,2082,1205,1145,937,45
2021-02-22 00:00:00,강원도,1826,1067,1009,817,44.74
2021-02-22 00:00:00,경상남도,1765,977,952,813,46.06
2021-02-22 00:00:00,충청북도,1413,819,809,604,42.75
2021-02-22 00:00:00,전라남도,1372,764,713,659,48.03
2021-02-22 00:00:00,전라북도,1320,762,711,609,46.14
2021-02-22 00:00:00,,954,755,660,294,30.82
2021-02-22 00:00:00,부산광역시,1360,714,711,649,47.72
2021-02-22 00:00:00,대전광역시,1103,619,618,485,43.97
2021-02-22 00:00:00,경기,811,557,451,360,44.39
2021-02-22 00:00:00,대구광역시,951,544,490,461,48.48
2021-02-22 00:00:00,광주광역시,921,486,483,438,47.56
2021-02-22 00:00:00,제주특별자치도,696,353,367,329,47.27
2021-02-22 00:00:00,울산광역시,529,287,288,241,45.56
2021-02-22 00:00:00,세종특별자치시,388,226,213,175,45.1
2021-02-22 00:00:00,인천광역,115,81,63,52,45.22
2021-02-22 00:00:00,충남,88,62,52,36,40.91
2021-02-22 00:00:00,인천,88,57,50,38,43.18
2021-02-22 00:00:00,경남,73,55,37,36,49.32
2021-02-22 00:00:00,강원,75,50,35,40,53.33
2021-02-22 00:00:00,경북,59,41,33,26,44.07
2021-02-22 00:00:00,충북,58,37,23,35,60.34
2021-02-22 00:00:00,전남,39,27,23,16,41.03
2021-02-22 00:00:00,부산광역,43,25,21,22,51.16
2021-02-22 00:00:00,광주,43,24,15,28,65.12
2021-02-22 00:00:00,대전,37,23,22,15,40.54
2021-02-22 00:00:00,대전광역,30,22,22,8,26.67
2021-02-22 00:00:00,★★★★★★★★,30,22,10,20,66.67
2021-02-22 00:00:00,전북,33,21,19,14,42.42
2021-02-22 00:00:00,부산,32,18,12,20,62.5
2021-02-22 00:00:00,대구광역,25,16,12,13,52
2021-02-22 00:00:00,광주광역,24,16,14,10,41.67
2021-02-22 00:00:00,대구,19,14,13,6,31.58
2021-02-22 00:00:00,제주도,17,11,3,14,82.35
2021-02-22 00:00:00,울산,15,10,8,7,46.67
2021-02-22 00:00:00,제주,8,7,6,2,25
2021-02-22 00:00:00,울,8,6,5,3,37.5
2021-02-22 00:00:00,서울강북구,6,5,4,2,33.33
2021-02-22 00:00:00,기,5,4,2,3,60
2021-02-22 00:00:00,울산광역,4,4,3,1,25
2021-02-22 00:00:00,서울시,5,3,3,2,40
2021-02-22 00:00:00,산,5,3,3,2,40
2021-02-22 00:00:00,주,1,1,1,0,0
2021-02-22 00:00:00,광주시,1,1,1,0,0
2021-02-22 00:00:00,원주시,4,1,0,4,100
2021-02-22 00:00:00,경기양평군양서면,1,1,1,0,0
2021-02-22 00:00:00,서초구,2,1,1,1,50
2021-02-22 00:00:00,남,1,1,1,0,0
2021-02-22 00:00:00,천,3,1,0,3,100
2021-02-22 00:00:00,인헌12다길,5,1,1,4,80
2021-03-01 00:00:00,서울특별시,41447,26662,22763,18684,45.08
2021-03-01 00:00:00,경기도,15114,9534,8322,6792,44.94
2021-03-01 00:00:00,인천광역시,2566,1554,1383,1183,46.1
2021-03-01 00:00:00,서울,1870,1352,1064,806,43.1
2021-03-01 00:00:00,충청남도,1873,1119,981,892,47.62
2021-03-01 00:00:00,경상북도,1704,978,890,814,47.77
2021-03-01 00:00:00,강원도,1501,906,821,680,45.3
2021-03-01 00:00:00,경상남도,1208,719,636,572,47.35
2021-03-01 00:00:00,충청북도,1076,645,581,495,46
2021-03-01 00:00:00,,787,641,552,235,29.86
2021-03-01 00:00:00,전라북도,1100,617,552,548,49.82
2021-03-01 00:00:00,전라남도,1051,617,572,479,45.58
2021-03-01 00:00:00,부산광역시,1010,569,523,487,48.22
2021-03-01 00:00:00,대전광역시,876,533,474,402,45.89
2021-03-01 00:00:00,경기,609,444,344,265,43.51
2021-03-01 00:00:00,대구광역시,698,401,379,319,45.7
2021-03-01 00:00:00,광주광역시,697,385,399,298,42.75
2021-03-01 00:00:00,제주특별자치도,561,312,277,284,50.62
2021-03-01 00:00:00,울산광역시,443,256,243,200,45.15
2021-03-01 00:00:00,세종특별자치시,332,191,181,151,45.48
2021-03-01 00:00:00,인천,100,63,47,53,53
2021-03-01 00:00:00,인천광역,72,58,45,27,37.5
2021-03-01 00:00:00,경북,61,38,33,28,45.9
2021-03-01 00:00:00,충남,55,35,27,28,50.91
2021-03-01 00:00:00,강원,47,34,24,23,48.94
2021-03-01 00:00:00,경남,65,34,25,40,61.54
2021-03-01 00:00:00,부산,41,27,29,12,29.27
2021-03-01 00:00:00,부산광역,34,23,21,13,38.24
2021-03-01 00:00:00,광주,34,22,17,17,50
2021-03-01 00:00:00,★★★★★★★★,25,19,11,14,56
2021-03-01 00:00:00,충북,27,18,16,11,40.74
2021-03-01 00:00:00,전북,24,16,13,11,45.83
2021-03-01 00:00:00,광주광역,22,14,14,8,36.36
2021-03-01 00:00:00,제주,28,14,18,10,35.71
2021-03-01 00:00:00,대전,22,12,11,11,50
2021-03-01 00:00:00,대전광역,12,11,10,2,16.67
2021-03-01 00:00:00,전남,16,11,8,8,50
2021-03-01 00:00:00,서울강북구,15,9,4,11,73.33
2021-03-01 00:00:00,대구,9,9,6,3,33.33
2021-03-01 00:00:00,제주도,13,9,6,7,53.85
2021-03-01 00:00:00,대구광역,10,8,9,1,10
2021-03-01 00:00:00,울,12,7,8,4,33.33
2021-03-01 00:00:00,울산,6,5,4,2,33.33
2021-03-01 00:00:00,기,4,4,3,1,25
2021-03-01 00:00:00,울산광역,5,4,3,2,40
2021-03-01 00:00:00,광주시,2,1,1,1,50
2021-03-01 00:00:00,산,1,1,0,1,100
2021-03-01 00:00:00,원주시,1,1,1,0,0
2021-03-01 00:00:00,인헌12다길,1,1,1,0,0
2021-03-01 00:00:00,인천직할시,1,1,1,0,0
2021-03-01 00:00:00,남,2,1,0,2,100
2021-03-01 00:00:00,서울시,1,1,0,1,100
2021-03-08 00:00:00,서울특별시,50131,31427,28072,22059,44
2021-03-08 00:00:00,경기도,18652,11367,10300,8352,44.78
2021-03-08 00:00:00,인천광역시,3079,1827,1709,1370,44.49
2021-03-08 00:00:00,서울,2277,1624,1342,935,41.06
2021-03-08 00:00:00,충청남도,2229,1341,1253,976,43.79
2021-03-08 00:00:00,경상북도,1946,1110,1044,902,46.35
2021-03-08 00:00:00,강원도,1675,1036,934,741,44.24
2021-03-08 00:00:00,경상남도,1730,919,860,870,50.29
2021-03-08 00:00:00,충청북도,1387,842,801,586,42.25
2021-03-08 00:00:00,,981,760,674,307,31.29
2021-03-08 00:00:00,전라북도,1334,745,687,647,48.5
2021-03-08 00:00:00,전라남도,1253,704,688,565,45.09
2021-03-08 00:00:00,부산광역시,1272,675,651,621,48.82
2021-03-08 00:00:00,대전광역시,1097,625,596,501,45.67
2021-03-08 00:00:00,대구광역시,905,539,508,397,43.87
2021-03-08 00:00:00,경기,725,491,412,313,43.17
2021-03-08 00:00:00,광주광역시,945,490,476,469,49.63
2021-03-08 00:00:00,제주특별자치도,722,377,376,346,47.92
2021-03-08 00:00:00,울산광역시,472,277,251,221,46.82
2021-03-08 00:00:00,세종특별자치시,380,212,213,167,43.95
2021-03-08 00:00:00,인천광역,124,93,72,52,41.94
2021-03-08 00:00:00,인천,93,72,63,30,32.26
2021-03-08 00:00:00,충남,89,62,50,39,43.82
2021-03-08 00:00:00,강원,73,45,34,39,53.42
2021-03-08 00:00:00,경남,76,42,45,31,40.79
2021-03-08 00:00:00,경북,53,36,32,21,39.62
2021-03-08 00:00:00,부산광역,48,33,30,18,37.5
2021-03-08 00:00:00,광주광역,46,31,22,24,52.17
2021-03-08 00:00:00,대전,35,26,20,15,42.86
2021-03-08 00:00:00,충북,32,23,22,10,31.25
2021-03-08 00:00:00,전북,33,23,26,7,21.21
2021-03-08 00:00:00,부산,33,22,18,15,45.45
2021-03-08 00:00:00,전남,30,22,18,12,40
2021-03-08 00:00:00,제주,22,17,12,10,45.45
2021-03-08 00:00:00,대전광역,26,16,10,16,61.54
2021-03-08 00:00:00,★★★★★★★★,20,15,15,5,25
2021-03-08 00:00:00,광주,18,13,10,8,44.44
2021-03-08 00:00:00,대구광역,24,12,11,13,54.17
2021-03-08 00:00:00,대구,23,12,11,12,52.17
2021-03-08 00:00:00,서울강북구,17,11,10,7,41.18
2021-03-08 00:00:00,제주도,12,10,10,2,16.67
2021-03-08 00:00:00,울산광역,11,8,6,5,45.45
2021-03-08 00:00:00,울산,15,8,9,6,40
2021-03-08 00:00:00,울,9,7,5,4,44.44
2021-03-08 00:00:00,천,7,5,6,1,14.29
2021-03-08 00:00:00,남,6,4,2,4,66.67
2021-03-08 00:00:00,기,3,2,0,3,100
2021-03-08 00:00:00,산,4,2,2,2,50
2021-03-08 00:00:00,서울시,4,2,0,4,100
2021-03-08 00:00:00,주,1,1,0,1,100
2021-03-08 00:00:00,서대문구,1,1,1,0,0
2021-03-08 00:00:00,인헌12다길,1,1,1,0,0
2021-03-08 00:00:00,서울강북구번3동,1,1,1,0,0
2021-03-08 00:00:00,경기도화성시송산동,1,1,1,0,0
2021-03-15 00:00:00,서울특별시,49177,30748,27535,21642,44.01
2021-03-15 00:00:00,경기도,18387,11261,10337,8050,43.78
2021-03-15 00:00:00,인천광역시,3202,1858,1749,1453,45.38
2021-03-15 00:00:00,서울,2275,1604,1311,964,42.37
2021-03-15 00:00:00,충청남도,2156,1261,1176,980,45.45
2021-03-15 00:00:00,경상북도,1952,1127,1040,912,46.72
2021-03-15 00:00:00,강원도,1729,1010,974,755,43.67
2021-03-15 00:00:00,경상남도,1609,860,811,798,49.6
2021-03-15 00:00:00,충청북도,1387,816,739,648,46.72
2021-03-15 00:00:00,,997,786,656,341,34.2
2021-03-15 00:00:00,전라남도,1369,740,699,670,48.94
2021-03-15 00:00:00,전라북도,1289,735,694,595,46.16
2021-03-15 00:00:00,부산광역시,1282,671,635,647,50.47
2021-03-15 00:00:00,대전광역시,1055,616,579,476,45.12
2021-03-15 00:00:00,경기,766,529,427,339,44.26
2021-03-15 00:00:00,광주광역시,855,467,470,385,45.03
2021-03-15 00:00:00,대구광역시,803,452,402,401,49.94
2021-03-15 00:00:00,제주특별자치도,737,392,371,366,49.66
2021-03-15 00:00:00,울산광역시,473,268,267,206,43.55
2021-03-15 00:00:00,세종특별자치시,353,212,201,152,43.06
2021-03-15 00:00:00,인천광역,132,102,83,49,37.12
2021-03-15 00:00:00,충남,85,59,49,36,42.35
2021-03-15 00:00:00,강원,59,47,34,25,42.37
2021-03-15 00:00:00,인천,60,43,37,23,38.33
2021-03-15 00:00:00,경남,63,41,32,31,49.21
2021-03-15 00:00:00,경북,63,39,37,26,41.27
2021-03-15 00:00:00,충북,48,31,24,24,50
2021-03-15 00:00:00,전남,49,27,22,27,55.1
2021-03-15 00:00:00,광주광역,30,23,15,15,50
2021-03-15 00:00:00,부산광역,34,22,12,22,64.71
2021-03-15 00:00:00,부산,30,21,12,18,60
2021-03-15 00:00:00,★★★★★★★★,27,20,11,16,59.26
2021-03-15 00:00:00,제주,24,17,12,12,50
2021-03-15 00:00:00,광주,23,16,14,9,39.13
2021-03-15 00:00:00,전북,20,16,16,4,20
2021-03-15 00:00:00,대전,26,16,15,11,42.31
2021-03-15 00:00:00,대전광역,27,16,16,11,40.74
2021-03-15 00:00:00,대구,24,16,14,10,41.67
2021-03-15 00:00:00,대구광역,22,14,12,10,45.45
2021-03-15 00:00:00,울산광역,21,12,9,12,57.14
2021-03-15 00:00:00,울산,11,9,5,6,54.55
2021-03-15 00:00:00,서울강북구,10,9,7,3,30
2021-03-15 00:00:00,제주도,10,8,6,4,40
2021-03-15 00:00:00,울,10,7,6,4,40
2021-03-15 00:00:00,기,6,5,3,3,50
2021-03-15 00:00:00,서울시,4,4,3,1,25
2021-03-15 00:00:00,주,2,2,2,0,0
2021-03-15 00:00:00,남,3,2,2,1,33.33
2021-03-22 00:00:00,서울특별시,49286,31120,27732,21554,43.73
2021-03-22 00:00:00,경기도,18480,11289,10351,8129,43.99
2021-03-22 00:00:00,인천광역시,3147,1840,1698,1449,46.04
2021-03-22 00:00:00,서울,2169,1549,1219,950,43.8
2021-03-22 00:00:00,충청남도,2176,1297,1213,963,44.26
2021-03-22 00:00:00,경상북도,2170,1185,1114,1056,48.66
2021-03-22 00:00:00,강원도,1761,1047,975,786,44.63
2021-03-22 00:00:00,경상남도,1668,926,840,828,49.64
2021-03-22 00:00:00,,1030,815,699,331,32.14
2021-03-22 00:00:00,충청북도,1316,777,733,583,44.3
2021-03-22 00:00:00,전라북도,1256,704,651,605,48.17
2021-03-22 00:00:00,전라남도,1236,696,645,591,47.82
2021-03-22 00:00:00,부산광역시,1252,683,639,613,48.96
2021-03-22 00:00:00,대전광역시,1042,592,569,473,45.39
2021-03-22 00:00:00,경기,796,576,434,362,45.48
2021-03-22 00:00:00,대구광역시,864,507,465,399,46.18
2021-03-22 00:00:00,광주광역시,817,445,412,405,49.57
2021-03-22 00:00:00,제주특별자치도,724,376,393,331,45.72
2021-03-22 00:00:00,울산광역시,511,271,264,247,48.34
2021-03-22 00:00:00,세종특별자치시,365,211,201,164,44.93
2021-03-22 00:00:00,인천광역,124,93,75,49,39.52
2021-03-22 00:00:00,충남,76,56,47,29,38.16
2021-03-22 00:00:00,인천,71,54,40,31,43.66
2021-03-22 00:00:00,경북,60,41,33,27,45
2021-03-22 00:00:00,경남,55,38,33,22,40
2021-03-22 00:00:00,강원,54,38,31,23,42.59
2021-03-22 00:00:00,충북,49,34,21,28,57.14
2021-03-22 00:00:00,★★★★★★★★,30,27,20,10,33.33
2021-03-22 00:00:00,전남,38,23,16,22,57.89
2021-03-22 00:00:00,부산,37,22,10,27,72.97
2021-03-22 00:00:00,광주광역,33,19,16,17,51.52
2021-03-22 00:00:00,대구광역,25,18,8,17,68
2021-03-22 00:00:00,부산광역,22,18,14,8,36.36
2021-03-22 00:00:00,전북,20,17,12,8,40
2021-03-22 00:00:00,광주,21,16,17,4,19.05
2021-03-22 00:00:00,대전광역,23,16,11,12,52.17
2021-03-22 00:00:00,대전,20,15,10,10,50
2021-03-22 00:00:00,대구,15,13,9,6,40
2021-03-22 00:00:00,제주도,16,10,6,10,62.5
2021-03-22 00:00:00,제주,14,9,7,7,50
2021-03-22 00:00:00,울,9,8,8,1,11.11
2021-03-22 00:00:00,울산광역,10,7,9,1,10
2021-03-22 00:00:00,울산,9,7,8,1,11.11
2021-03-22 00:00:00,서울강북구,9,7,6,3,33.33
2021-03-22 00:00:00,서울시,4,3,1,3,75
2021-03-22 00:00:00,기,3,3,3,0,0
2021-03-22 00:00:00,남,2,2,2,0,0
2021-03-22 00:00:00,경기의왕시포일동,3,2,2,1,33.33
2021-03-22 00:00:00,산,1,1,1,0,0
2021-03-22 00:00:00,강북구,1,1,1,0,0
2021-03-22 00:00:00,북,2,1,0,2,100
2021-03-22 00:00:00,서울관악구봉천1동,1,1,1,0,0
2021-03-29 00:00:00,서울특별시,47431,29848,26689,20742,43.73
2021-03-29 00:00:00,경기도,17586,10806,9836,7750,44.07
2021-03-29 00:00:00,인천광역시,2921,1737,1607,1314,44.98
2021-03-29 00:00:00,서울,2288,1575,1328,960,41.96
2021-03-29 00:00:00,충청남도,2179,1307,1218,961,44.1
2021-03-29 00:00:00,경상북도,1969,1078,1065,904,45.91
2021-03-29 00:00:00,강원도,1646,971,890,756,45.93
2021-03-29 00:00:00,경상남도,1537,875,815,722,46.97
2021-03-29 00:00:00,,1093,834,696,397,36.32
2021-03-29 00:00:00,충청북도,1293,772,731,562,43.46
2021-03-29 00:00:00,전라북도,1300,739,711,589,45.31
2021-03-29 00:00:00,전라남도,1282,693,647,635,49.53
2021-03-29 00:00:00,부산광역시,1193,671,646,547,45.85
2021-03-29 00:00:00,대전광역시,1074,603,549,525,48.88
2021-03-29 00:00:00,경기,747,527,424,323,43.24
2021-03-29 00:00:00,대구광역시,868,492,464,404,46.54
2021-03-29 00:00:00,광주광역시,764,413,412,352,46.07
2021-03-29 00:00:00,제주특별자치도,669,359,346,323,48.28
2021-03-29 00:00:00,울산광역시,520,292,282,238,45.77
2021-03-29 00:00:00,세종특별자치시,346,213,200,146,42.2
2021-03-29 00:00:00,인천광역,94,66,55,39,41.49
2021-03-29 00:00:00,충남,93,60,52,41,44.09
2021-03-29 00:00:00,경남,67,45,28,39,58.21
2021-03-29 00:00:00,강원,57,45,33,24,42.11
2021-03-29 00:00:00,경북,62,42,32,30,48.39
2021-03-29 00:00:00,인천,61,41,30,31,50.82
2021-03-29 00:00:00,충북,53,35,37,16,30.19
2021-03-29 00:00:00,부산광역,48,30,23,25,52.08
2021-03-29 00:00:00,전북,42,29,22,20,47.62
2021-03-29 00:00:00,부산,38,27,17,21,55.26
2021-03-29 00:00:00,광주광역,40,25,17,23,57.5
2021-03-29 00:00:00,전남,42,25,24,18,42.86
2021-03-29 00:00:00,광주,35,19,14,21,60
2021-03-29 00:00:00,대전,26,19,18,8,30.77
2021-03-29 00:00:00,대전광역,22,17,13,9,40.91
2021-03-29 00:00:00,대구광역,22,17,12,10,45.45
2021-03-29 00:00:00,★★★★★★★★,18,16,7,11,61.11
2021-03-29 00:00:00,제주,24,12,14,10,41.67
2021-03-29 00:00:00,대구,19,11,8,11,57.89
2021-03-29 00:00:00,울산광역,18,9,6,12,66.67
2021-03-29 00:00:00,서울강북구,9,8,7,2,22.22
2021-03-29 00:00:00,기,8,7,3,5,62.5
2021-03-29 00:00:00,제주도,7,6,6,1,14.29
2021-03-29 00:00:00,울,9,6,5,4,44.44
2021-03-29 00:00:00,울산,5,4,3,2,40
2021-03-29 00:00:00,서울시,7,4,2,5,71.43
2021-03-29 00:00:00,남,3,3,3,0,0
2021-03-29 00:00:00,강북구,1,1,0,1,100
2021-03-29 00:00:00,서대문구,1,1,1,0,0
2021-03-29 00:00:00,산,6,1,6,0,0
2021-03-29 00:00:00,서구,3,1,0,3,100
2021-04-05 00:00:00,서울특별시,48108,30164,26753,21355,44.39
2021-04-05 00:00:00,경기도,18397,11140,10218,8179,44.46
2021-04-05 00:00:00,인천광역시,3077,1797,1700,1377,44.75
2021-04-05 00:00:00,서울,2394,1698,1376,1018,42.52
2021-04-05 00:00:00,,1867,1589,724,1143,61.22
2021-04-05 00:00:00,충청남도,2224,1320,1252,972,43.71
2021-04-05 00:00:00,경상북도,1953,1101,1089,864,44.24
2021-04-05 00:00:00,강원도,1660,991,939,721,43.43
2021-04-05 00:00:00,경상남도,1638,930,875,763,46.58
2021-04-05 00:00:00,충청북도,1306,774,722,584,44.72
2021-04-05 00:00:00,전라남도,1340,725,704,636,47.46
2021-04-05 00:00:00,전라북도,1273,713,684,589,46.27
2021-04-05 00:00:00,부산광역시,1229,669,637,592,48.17
2021-04-05 00:00:00,대전광역시,1075,588,553,522,48.56
2021-04-05 00:00:00,경기,728,511,395,333,45.74
2021-04-05 00:00:00,대구광역시,900,500,461,439,48.78
2021-04-05 00:00:00,광주광역시,804,433,418,386,48.01
2021-04-05 00:00:00,제주특별자치도,637,336,339,298,46.78
2021-04-05 00:00:00,울산광역시,523,285,281,242,46.27
2021-04-05 00:00:00,세종특별자치시,328,184,176,152,46.34
2021-04-05 00:00:00,인천광역,117,87,70,47,40.17
2021-04-05 00:00:00,인천,69,50,36,33,47.83
2021-04-05 00:00:00,경남,71,48,36,35,49.3
2021-04-05 00:00:00,경북,71,47,46,25,35.21
2021-04-05 00:00:00,충남,67,46,42,25,37.31
2021-04-05 00:00:00,강원,60,38,39,21,35
2021-04-05 00:00:00,충북,49,34,25,24,48.98
2021-04-05 00:00:00,대전광역,38,26,18,20,52.63
2021-04-05 00:00:00,부산광역,29,24,19,10,34.48
2021-04-05 00:00:00,부산,33,23,17,16,48.48
2021-04-05 00:00:00,전남,38,22,15,23,60.53
2021-04-05 00:00:00,광주광역,36,22,19,17,47.22
2021-04-05 00:00:00,전북,43,21,24,19,44.19
2021-04-05 00:00:00,광주,22,15,11,11,50
2021-04-05 00:00:00,대구광역,21,14,13,8,38.1
2021-04-05 00:00:00,★★★★★★★★,19,13,10,9,47.37
2021-04-05 00:00:00,대구,21,13,13,8,38.1
2021-04-05 00:00:00,대전,19,13,8,11,57.89
2021-04-05 00:00:00,제주,20,10,10,10,50
2021-04-05 00:00:00,울산광역,14,9,6,8,57.14
2021-04-05 00:00:00,울산,16,7,6,10,62.5
2021-04-05 00:00:00,제주도,7,7,5,2,28.57
2021-04-05 00:00:00,기,10,6,5,5,50
2021-04-05 00:00:00,울,3,3,3,0,0
2021-04-05 00:00:00,서울강북구,7,3,3,4,57.14
2021-04-05 00:00:00,서울시,8,3,4,4,50
2021-04-05 00:00:00,산,3,1,2,1,33.33
2021-04-05 00:00:00,서구,4,1,1,3,75
2021-04-05 00:00:00,광주시,2,1,1,1,50
2021-04-05 00:00:00,천,2,1,1,1,50
2021-04-05 00:00:00,북,2,1,1,1,50
2021-04-05 00:00:00,남,1,1,1,0,0
2021-04-05 00:00:00,광진구,1,1,0,1,100
2021-04-12 00:00:00,서울특별시,48831,30733,27257,21574,44.18
2021-04-12 00:00:00,경기도,18500,11348,10145,8355,45.16
2021-04-12 00:00:00,인천광역시,3171,1847,1729,1442,45.47
2021-04-12 00:00:00,서울,2382,1679,1341,1041,43.7
2021-04-12 00:00:00,충청남도,2217,1329,1220,997,44.97
2021-04-12 00:00:00,경상북도,2032,1130,1100,932,45.87
2021-04-12 00:00:00,강원도,1796,1045,941,855,47.61
2021-04-12 00:00:00,경상남도,1580,882,796,784,49.62
2021-04-12 00:00:00,,1122,875,769,353,31.46
2021-04-12 00:00:00,충청북도,1342,799,719,623,46.42
2021-04-12 00:00:00,전라남도,1315,719,631,684,52.02
2021-04-12 00:00:00,부산광역시,1277,706,672,605,47.38
2021-04-12 00:00:00,전라북도,1242,688,662,580,46.7
2021-04-12 00:00:00,대전광역시,1117,631,566,551,49.33
2021-04-12 00:00:00,경기,745,536,433,312,41.88
2021-04-12 00:00:00,대구광역시,917,504,467,450,49.07
2021-04-12 00:00:00,광주광역시,818,446,415,403,49.27
2021-04-12 00:00:00,제주특별자치도,683,382,364,319,46.71
2021-04-12 00:00:00,울산광역시,558,295,298,260,46.59
2021-04-12 00:00:00,세종특별자치시,317,186,178,139,43.85
2021-04-12 00:00:00,인천광역,101,77,60,41,40.59
2021-04-12 00:00:00,인천,76,60,50,26,34.21
2021-04-12 00:00:00,충남,88,55,40,48,54.55
2021-04-12 00:00:00,경북,63,44,33,30,47.62
2021-04-12 00:00:00,강원,60,43,39,21,35
2021-04-12 00:00:00,충북,61,41,24,37,60.66
2021-04-12 00:00:00,경남,55,38,31,24,43.64
2021-04-12 00:00:00,전북,41,27,18,23,56.1
2021-04-12 00:00:00,★★★★★★★★,39,26,20,19,48.72
2021-04-12 00:00:00,전남,38,23,24,14,36.84
2021-04-12 00:00:00,광주광역,32,22,21,11,34.38
2021-04-12 00:00:00,부산,29,20,17,12,41.38
2021-04-12 00:00:00,부산광역,32,20,13,19,59.38
2021-04-12 00:00:00,대구광역,27,19,15,12,44.44
2021-04-12 00:00:00,광주,29,17,14,15,51.72
2021-04-12 00:00:00,대구,27,17,15,12,44.44
2021-04-12 00:00:00,울산,24,15,13,11,45.83
2021-04-12 00:00:00,대전,23,14,9,14,60.87
2021-04-12 00:00:00,대전광역,17,13,12,5,29.41
2021-04-12 00:00:00,제주,17,13,9,8,47.06
2021-04-12 00:00:00,서울강북구,14,11,9,5,35.71
2021-04-12 00:00:00,울산광역,14,8,5,9,64.29
2021-04-12 00:00:00,제주도,8,6,5,3,37.5
2021-04-12 00:00:00,서울시,7,5,3,4,57.14
2021-04-12 00:00:00,울,8,4,5,3,37.5
2021-04-12 00:00:00,기,7,3,3,4,57.14
2021-04-12 00:00:00,남,2,1,2,0,0
2021-04-12 00:00:00,원,1,1,1,0,0
2021-04-12 00:00:00,주,1,1,1,0,0
2021-04-12 00:00:00,강북구,2,1,1,1,50
2021-04-12 00:00:00,광진구,1,1,1,0,0
2021-04-12 00:00:00,산,2,1,2,0,0
2021-04-19 00:00:00,서울특별시,49345,31069,27828,21517,43.61
2021-04-19 00:00:00,경기도,18655,11378,10505,8150,43.69
2021-04-19 00:00:00,인천광역시,3075,1876,1695,1380,44.88
2021-04-19 00:00:00,서울,2304,1610,1344,960,41.67
2021-04-19 00:00:00,충청남도,2249,1383,1329,920,40.91
2021-04-19 00:00:00,경상북도,2092,1184,1168,924,44.17
2021-04-19 00:00:00,강원도,1747,1016,956,791,45.28
2021-04-19 00:00:00,경상남도,1674,922,881,793,47.37
2021-04-19 00:00:00,충청북도,1447,872,833,614,42.43
2021-04-19 00:00:00,,1117,851,706,411,36.79
2021-04-19 00:00:00,전라남도,1429,820,764,665,46.54
2021-04-19 00:00:00,전라북도,1354,734,682,672,49.63
2021-04-19 00:00:00,부산광역시,1349,723,687,662,49.07
2021-04-19 00:00:00,대전광역시,1072,608,569,503,46.92
2021-04-19 00:00:00,대구광역시,982,535,489,493,50.2
2021-04-19 00:00:00,경기,742,510,408,334,45.01
2021-04-19 00:00:00,광주광역시,766,452,433,333,43.47
2021-04-19 00:00:00,제주특별자치도,657,349,380,277,42.16
2021-04-19 00:00:00,울산광역시,530,300,260,270,50.94
2021-04-19 00:00:00,세종특별자치시,364,212,187,177,48.63
2021-04-19 00:00:00,인천광역,132,95,83,49,37.12
2021-04-19 00:00:00,충남,85,65,54,31,36.47
2021-04-19 00:00:00,경북,105,61,55,50,47.62
2021-04-19 00:00:00,인천,69,51,37,32,46.38
2021-04-19 00:00:00,전북,71,43,35,36,50.7
2021-04-19 00:00:00,충북,53,40,29,24,45.28
2021-04-19 00:00:00,경남,66,37,23,43,65.15
2021-04-19 00:00:00,강원,40,29,21,19,47.5
2021-04-19 00:00:00,부산광역,42,26,17,25,59.52
2021-04-19 00:00:00,대전광역,37,26,16,21,56.76
2021-04-19 00:00:00,대전,43,24,26,17,39.53
2021-04-19 00:00:00,★★★★★★★★,38,23,18,20,52.63
2021-04-19 00:00:00,전남,37,21,21,16,43.24
2021-04-19 00:00:00,광주,39,21,16,23,58.97
2021-04-19 00:00:00,대구,25,20,16,9,36
2021-04-19 00:00:00,광주광역,24,19,14,10,41.67
2021-04-19 00:00:00,부산,23,15,10,13,56.52
2021-04-19 00:00:00,대구광역,18,13,8,10,55.56
2021-04-19 00:00:00,울산,20,13,14,6,30
2021-04-19 00:00:00,울,10,9,4,6,60
2021-04-19 00:00:00,제주도,16,9,8,8,50
2021-04-19 00:00:00,제주,10,8,8,2,20
2021-04-19 00:00:00,울산광역,7,7,7,0,0
2021-04-19 00:00:00,서울시,5,4,3,2,40
2021-04-19 00:00:00,기,5,4,2,3,60
2021-04-19 00:00:00,남,5,3,1,4,80
2021-04-19 00:00:00,서울강북구,3,2,2,1,33.33
2021-04-19 00:00:00,원,3,2,2,1,33.33
2021-04-19 00:00:00,세종시,2,1,2,0,0
2021-04-19 00:00:00,주공아파트,1,1,1,0,0
2021-04-19 00:00:00,산,2,1,1,1,50
2021-04-19 00:00:00,천,1,1,1,0,0
2021-04-19 00:00:00,강북구,1,1,1,0,0
2021-04-19 00:00:00,경기도양주군회천읍,1,1,0,1,100
2021-04-26 00:00:00,서울특별시,48223,30357,27257,20966,43.48
2021-04-26 00:00:00,경기도,17793,11069,10182,7611,42.78
2021-04-26 00:00:00,인천광역시,2971,1762,1672,1299,43.72
2021-04-26 00:00:00,서울,2244,1590,1341,903,40.24
2021-04-26 00:00:00,충청남도,2124,1291,1179,945,44.49
2021-04-26 00:00:00,경상북도,1976,1130,1065,911,46.1
2021-04-26 00:00:00,강원도,1877,1061,992,885,47.15
2021-04-26 00:00:00,경상남도,1654,901,872,782,47.28
2021-04-26 00:00:00,,1067,837,700,367,34.4
2021-04-26 00:00:00,충청북도,1391,819,759,632,45.43
2021-04-26 00:00:00,전라북도,1351,764,752,599,44.34
2021-04-26 00:00:00,부산광역시,1428,738,697,731,51.19
2021-04-26 00:00:00,전라남도,1308,727,725,583,44.57
2021-04-26 00:00:00,대전광역시,1080,642,594,486,45
2021-04-26 00:00:00,경기,703,501,394,309,43.95
2021-04-26 00:00:00,대구광역시,857,492,467,390,45.51
2021-04-26 00:00:00,광주광역시,761,407,398,363,47.7
2021-04-26 00:00:00,제주특별자치도,709,384,407,302,42.6
2021-04-26 00:00:00,울산광역시,541,291,275,266,49.17
2021-04-26 00:00:00,세종특별자치시,339,197,186,153,45.13
2021-04-26 00:00:00,인천광역,132,90,75,57,43.18
2021-04-26 00:00:00,경남,89,54,49,40,44.94
2021-04-26 00:00:00,충남,72,53,42,30,41.67
2021-04-26 00:00:00,경북,91,52,49,42,46.15
2021-04-26 00:00:00,강원,65,43,37,28,43.08
2021-04-26 00:00:00,인천,64,42,37,27,42.19
2021-04-26 00:00:00,충북,48,33,30,18,37.5
2021-04-26 00:00:00,전북,33,26,18,15,45.45
2021-04-26 00:00:00,대전광역,35,25,20,15,42.86
2021-04-26 00:00:00,부산광역,34,24,21,13,38.24
2021-04-26 00:00:00,광주,40,23,21,19,47.5
2021-04-26 00:00:00,전남,33,23,14,19,57.58
2021-04-26 00:00:00,★★★★★★★★,32,23,21,11,34.38
2021-04-26 00:00:00,대전,27,22,18,9,33.33
2021-04-26 00:00:00,광주광역,27,20,14,13,48.15
2021-04-26 00:00:00,대구광역,29,19,14,15,51.72
2021-04-26 00:00:00,부산,29,18,15,14,48.28
2021-04-26 00:00:00,울,17,13,11,6,35.29
2021-04-26 00:00:00,서울강북구,14,10,11,3,21.43
2021-04-26 00:00:00,울산,18,9,9,9,50
2021-04-26 00:00:00,울산광역,14,8,5,9,64.29
2021-04-26 00:00:00,제주도,9,7,8,1,11.11
2021-04-26 00:00:00,대구,14,7,5,9,64.29
2021-04-26 00:00:00,기,11,6,4,7,63.64
2021-04-26 00:00:00,제주,15,6,8,7,46.67
2021-04-26 00:00:00,남,5,3,2,3,60
2021-04-26 00:00:00,서울시,2,2,1,1,50
2021-04-26 00:00:00,강서구,3,1,0,3,100
2021-04-26 00:00:00,경기용인시풍덕천2동,1,1,1,0,0
2021-04-26 00:00:00,강북구,1,1,1,0,0
2021-04-26 00:00:00,경기도화성시송산동,1,1,1,0,0
2021-04-26 00:00:00,강동구,1,1,1,0,0
2021-04-26 00:00:00,북,3,1,1,2,66.67
2021-04-26 00:00:00,전,1,1,1,0,0
2021-04-26 00:00:00,서울관악구봉천1동,1,1,1,0,0
2021-04-26 00:00:00,산,2,1,0,2,100
2021-05-03 00:00:00,서울특별시,41453,26621,22219,19234,46.4
2021-05-03 00:00:00,경기도,15305,9609,8222,7083,46.28
2021-05-03 00:00:00,인천광역시,2580,1563,1362,1218,47.21
2021-05-03 00:00:00,서울,1869,1371,1032,837,44.78
2021-05-03 00:00:00,충청남도,1807,1101,958,849,46.98
2021-05-03 00:00:00,경상북도,1723,963,882,841,48.81
2021-05-03 00:00:00,강원도,1417,871,719,698,49.26
2021-05-03 00:00:00,경상남도,1299,713,677,622,47.88
2021-05-03 00:00:00,충청북도,1141,704,601,540,47.33
2021-05-03 00:00:00,,895,699,618,277,30.95
2021-05-03 00:00:00,전라북도,1064,616,562,502,47.18
2021-05-03 00:00:00,전라남도,1021,598,531,490,47.99
2021-05-03 00:00:00,부산광역시,1089,571,544,545,50.05
2021-05-03 00:00:00,대전광역시,880,512,458,422,47.95
2021-05-03 00:00:00,경기,617,422,315,302,48.95
2021-05-03 00:00:00,대구광역시,742,419,355,387,52.16
2021-05-03 00:00:00,광주광역시,648,369,332,316,48.77
2021-05-03 00:00:00,제주특별자치도,512,264,276,236,46.09
2021-05-03 00:00:00,울산광역시,460,258,254,206,44.78
2021-05-03 00:00:00,세종특별자치시,345,196,180,165,47.83
2021-05-03 00:00:00,인천광역,122,82,64,58,47.54
2021-05-03 00:00:00,인천,61,41,30,31,50.82
2021-05-03 00:00:00,충남,55,40,28,27,49.09
2021-05-03 00:00:00,경북,56,35,35,21,37.5
2021-05-03 00:00:00,전북,49,31,25,24,48.98
2021-05-03 00:00:00,강원,44,31,25,19,43.18
2021-05-03 00:00:00,경남,37,26,16,21,56.76
2021-05-03 00:00:00,충북,30,22,14,16,53.33
2021-05-03 00:00:00,광주광역,33,20,16,17,51.52
2021-05-03 00:00:00,★★★★★★★★,30,18,17,13,43.33
2021-05-03 00:00:00,전남,27,18,19,8,29.63
2021-05-03 00:00:00,부산광역,26,17,11,15,57.69
2021-05-03 00:00:00,부산,20,13,12,8,40
2021-05-03 00:00:00,대전,21,13,4,17,80.95
2021-05-03 00:00:00,대구광역,14,12,12,2,14.29
2021-05-03 00:00:00,울산,22,10,10,12,54.55
2021-05-03 00:00:00,대전광역,16,10,6,10,62.5
2021-05-03 00:00:00,광주,13,9,9,4,30.77
2021-05-03 00:00:00,대구,18,9,7,11,61.11
2021-05-03 00:00:00,제주도,8,6,6,2,25
2021-05-03 00:00:00,서울강북구,7,6,3,4,57.14
2021-05-03 00:00:00,울,11,5,3,8,72.73
2021-05-03 00:00:00,울산광역,10,5,5,5,50
2021-05-03 00:00:00,제주,5,4,3,2,40
2021-05-03 00:00:00,기,5,4,5,0,0
2021-05-03 00:00:00,산,2,1,2,0,0
2021-05-03 00:00:00,강북구,2,1,0,2,100
2021-05-03 00:00:00,원,1,1,1,0,0
2021-05-03 00:00:00,주,1,1,1,0,0
2021-05-03 00:00:00,인헌12다길,2,1,1,1,50
2021-05-03 00:00:00,충부,2,1,0,2,100
2021-05-03 00:00:00,서울시,1,1,0,1,100
2021-05-03 00:00:00,남,1,1,1,0,0
2021-05-10 00:00:00,서울특별시,50992,32233,28688,22304,43.74
2021-05-10 00:00:00,경기도,18823,11622,10640,8183,43.47
2021-05-10 00:00:00,인천광역시,3199,1929,1755,1444,45.14
2021-05-10 00:00:00,서울,2398,1686,1387,1011,42.16
2021-05-10 00:00:00,충청남도,2251,1364,1277,974,43.27
2021-05-10 00:00:00,경상북도,2130,1183,1138,992,46.57
2021-05-10 00:00:00,강원도,1769,1053,951,818,46.24
2021-05-10 00:00:00,경상남도,1635,897,845,790,48.32
2021-05-10 00:00:00,,1136,880,711,425,37.41
2021-05-10 00:00:00,충청북도,1366,825,782,584,42.75
2021-05-10 00:00:00,부산광역시,1424,772,710,714,50.14
2021-05-10 00:00:00,전라북도,1349,772,718,631,46.78
2021-05-10 00:00:00,전라남도,1264,711,677,587,46.44
2021-05-10 00:00:00,대전광역시,1169,672,619,550,47.05
2021-05-10 00:00:00,경기,785,562,448,337,42.93
2021-05-10 00:00:00,대구광역시,1025,541,515,510,49.76
2021-05-10 00:00:00,광주광역시,855,470,454,401,46.9
2021-05-10 00:00:00,제주특별자치도,665,375,363,302,45.41
2021-05-10 00:00:00,울산광역시,528,294,281,247,46.78
2021-05-10 00:00:00,세종특별자치시,369,220,233,136,36.86
2021-05-10 00:00:00,인천광역,110,84,62,48,43.64
2021-05-10 00:00:00,충남,89,64,47,42,47.19
2021-05-10 00:00:00,인천,92,61,47,45,48.91
2021-05-10 00:00:00,강원,62,45,39,23,37.1
2021-05-10 00:00:00,경북,58,42,33,25,43.1
2021-05-10 00:00:00,충북,61,40,37,24,39.34
2021-05-10 00:00:00,경남,62,37,27,35,56.45
2021-05-10 00:00:00,전북,53,35,29,24,45.28
2021-05-10 00:00:00,부산광역,42,29,29,13,30.95
2021-05-10 00:00:00,대전광역,51,28,21,30,58.82
2021-05-10 00:00:00,부산,46,25,21,25,54.35
2021-05-10 00:00:00,광주,39,23,16,23,58.97
2021-05-10 00:00:00,★★★★★★★★,28,19,20,8,28.57
2021-05-10 00:00:00,대전,26,18,17,9,34.62
2021-05-10 00:00:00,대구광역,27,18,15,12,44.44
2021-05-10 00:00:00,전남,28,17,16,12,42.86
2021-05-10 00:00:00,광주광역,16,13,7,9,56.25
2021-05-10 00:00:00,울산,18,12,6,12,66.67
2021-05-10 00:00:00,제주도,25,11,11,14,56
2021-05-10 00:00:00,울산광역,14,11,8,6,42.86
2021-05-10 00:00:00,서울강북구,11,10,10,1,9.09
2021-05-10 00:00:00,대구,13,10,7,6,46.15
2021-05-10 00:00:00,울,7,6,6,1,14.29
2021-05-10 00:00:00,제주,9,5,5,4,44.44
2021-05-10 00:00:00,남,6,5,5,1,16.67
2021-05-10 00:00:00,서울시,4,3,3,1,25
2021-05-10 00:00:00,산,2,2,0,2,100
2021-05-10 00:00:00,북,3,2,1,2,66.67
2021-05-10 00:00:00,천,2,2,2,0,0
2021-05-10 00:00:00,강서구,1,1,1,0,0
2021-05-10 00:00:00,기,2,1,0,2,100
2021-05-10 00:00:00,광주시,2,1,1,1,50
2021-05-10 00:00:00,전,2,1,0,2,100
2021-05-10 00:00:00,부산시,1,1,1,0,0
2021-05-17 00:00:00,서울특별시,41286,26754,22678,18608,45.07
2021-05-17 00:00:00,경기도,15017,9472,8202,6815,45.38
2021-05-17 00:00:00,인천광역시,2592,1590,1463,1129,43.56
2021-05-17 00:00:00,서울,1891,1358,1079,812,42.94
2021-05-17 00:00:00,충청남도,1945,1173,1068,877,45.09
2021-05-17 00:00:00,경상북도,1770,1007,920,850,48.02
2021-05-17 00:00:00,강원도,1429,852,745,684,47.87
2021-05-17 00:00:00,경상남도,1361,750,705,656,48.2
2021-05-17 00:00:00,,897,744,679,218,24.3
2021-05-17 00:00:00,충청북도,1159,713,663,496,42.8
2021-05-17 00:00:00,부산광역시,1177,650,575,602,51.15
2021-05-17 00:00:00,전라남도,1047,610,576,471,44.99
2021-05-17 00:00:00,전라북도,1112,608,553,559,50.27
2021-05-17 00:00:00,대전광역시,971,573,521,450,46.34
2021-05-17 00:00:00,대구광역시,794,450,412,382,48.11
2021-05-17 00:00:00,경기,626,449,330,296,47.28
2021-05-17 00:00:00,광주광역시,664,372,347,317,47.74
2021-05-17 00:00:00,제주특별자치도,501,295,266,235,46.91
2021-05-17 00:00:00,울산광역시,402,231,218,184,45.77
2021-05-17 00:00:00,세종특별자치시,285,178,159,126,44.21
2021-05-17 00:00:00,인천광역,84,60,46,38,45.24
2021-05-17 00:00:00,충남,87,50,46,41,47.13
2021-05-17 00:00:00,인천,65,45,26,39,60
2021-05-17 00:00:00,경북,58,33,27,31,53.45
2021-05-17 00:00:00,강원,47,32,25,22,46.81
2021-05-17 00:00:00,경남,46,32,29,17,36.96
2021-05-17 00:00:00,충북,40,28,23,17,42.5
2021-05-17 00:00:00,전북,39,24,21,18,46.15
2021-05-17 00:00:00,부산,37,24,19,18,48.65
2021-05-17 00:00:00,대전광역,34,20,18,16,47.06
2021-05-17 00:00:00,광주광역,27,19,17,10,37.04
2021-05-17 00:00:00,전남,23,17,15,8,34.78
2021-05-17 00:00:00,대전,27,17,14,13,48.15
2021-05-17 00:00:00,대구광역,17,15,12,5,29.41
2021-05-17 00:00:00,★★★★★★★★,18,15,8,10,55.56
2021-05-17 00:00:00,부산광역,21,15,8,13,61.9
2021-05-17 00:00:00,울산,16,11,11,5,31.25
2021-05-17 00:00:00,대구,16,10,5,11,68.75
2021-05-17 00:00:00,광주,14,9,10,4,28.57
2021-05-17 00:00:00,제주,17,9,5,12,70.59
2021-05-17 00:00:00,제주도,11,8,6,5,45.45
2021-05-17 00:00:00,서울강북구,8,8,7,1,12.5
2021-05-17 00:00:00,울산광역,7,5,4,3,42.86
2021-05-17 00:00:00,기,5,4,1,4,80
2021-05-17 00:00:00,울,6,4,4,2,33.33
2021-05-17 00:00:00,산,5,3,4,1,20
2021-05-17 00:00:00,서울관악구봉천1동,2,2,1,1,50
2021-05-17 00:00:00,서울시,4,2,0,4,100
2021-05-17 00:00:00,원주시,1,1,0,1,100
2021-05-17 00:00:00,충부,1,1,1,0,0
2021-05-17 00:00:00,강북구,1,1,1,0,0
2021-05-24 00:00:00,서울특별시,51002,31987,28425,22577,44.27
2021-05-24 00:00:00,경기도,18180,11356,10215,7965,43.81
2021-05-24 00:00:00,인천광역시,3348,1956,1836,1512,45.16
2021-05-24 00:00:00,서울,2336,1625,1360,976,41.78
2021-05-24 00:00:00,충청남도,2247,1354,1261,986,43.88
2021-05-24 00:00:00,경상북도,2092,1132,1080,1012,48.37
2021-05-24 00:00:00,강원도,1837,1071,1008,829,45.13
2021-05-24 00:00:00,경상남도,1749,913,882,867,49.57
2021-05-24 00:00:00,충청북도,1494,872,817,677,45.31
2021-05-24 00:00:00,,1078,838,732,346,32.1
2021-05-24 00:00:00,부산광역시,1407,788,773,634,45.06
2021-05-24 00:00:00,전라북도,1365,773,759,606,44.4
2021-05-24 00:00:00,전라남도,1313,715,707,606,46.15
2021-05-24 00:00:00,대전광역시,1116,650,617,499,44.71
2021-05-24 00:00:00,경기,788,542,451,337,42.77
2021-05-24 00:00:00,대구광역시,1008,538,551,457,45.34
2021-05-24 00:00:00,광주광역시,821,474,456,365,44.46
2021-05-24 00:00:00,제주특별자치도,700,383,370,330,47.14
2021-05-24 00:00:00,울산광역시,529,281,267,262,49.53
2021-05-24 00:00:00,세종특별자치시,370,229,206,164,44.32
2021-05-24 00:00:00,인천광역,124,90,65,59,47.58
2021-05-24 00:00:00,인천,106,66,58,48,45.28
2021-05-24 00:00:00,충남,74,51,46,28,37.84
2021-05-24 00:00:00,경북,81,47,42,39,48.15
2021-05-24 00:00:00,전북,65,41,42,23,35.38
2021-05-24 00:00:00,강원,51,41,33,18,35.29
2021-05-24 00:00:00,경남,50,32,26,24,48
2021-05-24 00:00:00,충북,49,30,26,23,46.94
2021-05-24 00:00:00,부산광역,48,27,26,22,45.83
2021-05-24 00:00:00,부산,33,24,15,18,54.55
2021-05-24 00:00:00,대전광역,34,24,16,18,52.94
2021-05-24 00:00:00,대전,40,22,16,24,60
2021-05-24 00:00:00,전남,33,21,22,11,33.33
2021-05-24 00:00:00,★★★★★★★★,26,19,7,19,73.08
2021-05-24 00:00:00,광주광역,34,18,14,20,58.82
2021-05-24 00:00:00,광주,25,18,20,5,20
2021-05-24 00:00:00,대구광역,25,16,12,13,52
2021-05-24 00:00:00,대구,21,14,12,9,42.86
2021-05-24 00:00:00,제주도,18,12,10,8,44.44
2021-05-24 00:00:00,울산광역,13,9,7,6,46.15
2021-05-24 00:00:00,제주,14,9,7,7,50
2021-05-24 00:00:00,울산,17,8,8,9,52.94
2021-05-24 00:00:00,울,9,7,6,3,33.33
2021-05-24 00:00:00,서울강북구,7,7,7,0,0
2021-05-24 00:00:00,서울시,6,4,2,4,66.67
2021-05-24 00:00:00,남,6,2,2,4,66.67
2021-05-24 00:00:00,기,3,2,1,2,66.67
2021-05-24 00:00:00,남동구만수2동,2,1,0,2,100
2021-05-24 00:00:00,원주시,1,1,1,0,0
2021-05-24 00:00:00,산,6,1,5,1,16.67
2021-05-24 00:00:00,서울관악구봉천1동,1,1,1,0,0
2021-05-24 00:00:00,천,1,1,0,1,100
2021-05-24 00:00:00,원,2,1,2,0,0
2021-05-24 00:00:00,전,1,1,1,0,0
2021-05-31 00:00:00,서울특별시,49744,31452,27412,22332,44.89
2021-05-31 00:00:00,경기도,18170,11214,10086,8084,44.49
2021-05-31 00:00:00,인천광역시,3116,1865,1731,1385,44.45
2021-05-31 00:00:00,서울,2331,1630,1311,1020,43.76
2021-05-31 00:00:00,충청남도,2092,1269,1166,926,44.26
2021-05-31 00:00:00,경상북도,2152,1199,1120,1032,47.96
2021-05-31 00:00:00,,1384,1149,736,648,46.82
2021-05-31 00:00:00,강원도,1738,1024,925,813,46.78
2021-05-31 00:00:00,경상남도,1700,881,870,830,48.82
2021-05-31 00:00:00,충청북도,1412,851,772,640,45.33
2021-05-31 00:00:00,전라북도,1286,730,693,593,46.11
2021-05-31 00:00:00,전라남도,1242,690,654,588,47.34
2021-05-31 00:00:00,부산광역시,1252,690,617,635,50.72
2021-05-31 00:00:00,대전광역시,1118,645,596,522,46.69
2021-05-31 00:00:00,경기,724,496,384,340,46.96
2021-05-31 00:00:00,대구광역시,916,488,446,470,51.31
2021-05-31 00:00:00,광주광역시,765,437,391,374,48.89
2021-05-31 00:00:00,제주특별자치도,706,361,375,331,46.88
2021-05-31 00:00:00,울산광역시,511,285,259,252,49.32
2021-05-31 00:00:00,세종특별자치시,427,232,232,195,45.67
2021-05-31 00:00:00,인천광역,140,92,75,65,46.43
2021-05-31 00:00:00,인천,82,58,50,32,39.02
2021-05-31 00:00:00,충남,75,51,43,32,42.67
2021-05-31 00:00:00,경북,62,41,33,29,46.77
2021-05-31 00:00:00,강원,60,41,37,23,38.33
2021-05-31 00:00:00,충북,40,31,21,19,47.5
2021-05-31 00:00:00,전북,52,30,20,32,61.54
2021-05-31 00:00:00,대전,42,23,27,15,35.71
2021-05-31 00:00:00,경남,30,22,15,15,50
2021-05-31 00:00:00,광주광역,31,22,14,17,54.84
2021-05-31 00:00:00,전남,27,20,9,18,66.67
2021-05-31 00:00:00,부산광역,33,20,16,17,51.52
2021-05-31 00:00:00,★★★★★★★★,22,19,9,13,59.09
2021-05-31 00:00:00,부산,27,18,16,11,40.74
2021-05-31 00:00:00,대구광역,29,17,19,10,34.48
2021-05-31 00:00:00,대전광역,20,17,12,8,40
2021-05-31 00:00:00,대구,26,16,16,10,38.46
2021-05-31 00:00:00,광주,18,12,6,12,66.67
2021-05-31 00:00:00,울산광역,18,12,11,7,38.89
2021-05-31 00:00:00,제주도,15,10,8,7,46.67
2021-05-31 00:00:00,울산,12,9,9,3,25
2021-05-31 00:00:00,제주,14,9,10,4,28.57
2021-05-31 00:00:00,울,9,8,7,2,22.22
2021-05-31 00:00:00,서울강북구,10,8,5,5,50
2021-05-31 00:00:00,기,7,4,4,3,42.86
2021-05-31 00:00:00,강북구,3,2,1,2,66.67
2021-05-31 00:00:00,경기도화성시송산동,3,2,2,1,33.33
2021-05-31 00:00:00,경기용인시풍덕천2동,1,1,1,0,0
2021-05-31 00:00:00,남,1,1,1,0,0
2021-05-31 00:00:00,광주시,2,1,0,2,100
2021-05-31 00:00:00,남동구만수2동,1,1,1,0,0
2021-05-31 00:00:00,서울시,1,1,0,1,100
2021-05-31 00:00:00,산,1,1,1,0,0
2021-05-31 00:00:00,서울관악구봉천1동,1,1,0,1,100
2021-05-31 00:00:00,주,2,1,0,2,100
2021-06-07 00:00:00,서울특별시,49732,31411,27377,22355,44.95
2021-06-07 00:00:00,경기도,18179,11154,9801,8378,46.09
2021-06-07 00:00:00,인천광역시,3084,1863,1702,1382,44.81
2021-06-07 00:00:00,서울,2295,1623,1334,961,41.87
2021-06-07 00:00:00,충청남도,2034,1213,1104,930,45.72
2021-06-07 00:00:00,경상북도,2026,1166,1081,945,46.64
2021-06-07 00:00:00,강원도,1716,992,878,838,48.83
2021-06-07 00:00:00,경상남도,1611,880,837,774,48.04
2021-06-07 00:00:00,,1107,879,737,370,33.42
2021-06-07 00:00:00,충청북도,1411,805,722,689,48.83
2021-06-07 00:00:00,전라남도,1389,745,702,687,49.46
2021-06-07 00:00:00,전라북도,1290,716,663,627,48.6
2021-06-07 00:00:00,부산광역시,1311,707,644,667,50.88
2021-06-07 00:00:00,대전광역시,1057,586,538,519,49.1
2021-06-07 00:00:00,대구광역시,967,516,489,478,49.43
2021-06-07 00:00:00,경기,648,478,383,265,40.9
2021-06-07 00:00:00,광주광역시,819,432,405,414,50.55
2021-06-07 00:00:00,제주특별자치도,660,346,317,343,51.97
2021-06-07 00:00:00,울산광역시,477,267,248,229,48.01
2021-06-07 00:00:00,세종특별자치시,395,212,219,176,44.56
2021-06-07 00:00:00,인천광역,97,70,62,35,36.08
2021-06-07 00:00:00,충남,87,60,55,32,36.78
2021-06-07 00:00:00,인천,83,57,45,38,45.78
2021-06-07 00:00:00,경북,71,48,42,29,40.85
2021-06-07 00:00:00,강원,66,46,37,29,43.94
2021-06-07 00:00:00,충북,38,27,19,19,50
2021-06-07 00:00:00,전북,31,22,21,10,32.26
2021-06-07 00:00:00,경남,31,21,16,15,48.39
2021-06-07 00:00:00,부산,36,21,11,25,69.44
2021-06-07 00:00:00,대전,33,20,14,19,57.58
2021-06-07 00:00:00,★★★★★★★★,24,19,15,9,37.5
2021-06-07 00:00:00,대전광역,23,17,11,12,52.17
2021-06-07 00:00:00,광주광역,20,16,10,10,50
2021-06-07 00:00:00,제주도,25,16,9,16,64
2021-06-07 00:00:00,전남,20,15,14,6,30
2021-06-07 00:00:00,부산광역,20,14,11,9,45
2021-06-07 00:00:00,광주,28,14,14,14,50
2021-06-07 00:00:00,대구,17,12,10,7,41.18
2021-06-07 00:00:00,대구광역,18,12,10,8,44.44
2021-06-07 00:00:00,서울강북구,16,12,11,5,31.25
2021-06-07 00:00:00,울산,14,12,7,7,50
2021-06-07 00:00:00,제주,9,8,7,2,22.22
2021-06-07 00:00:00,울,6,5,4,2,33.33
2021-06-07 00:00:00,울산광역,8,4,3,5,62.5
2021-06-07 00:00:00,기,4,3,4,0,0
2021-06-07 00:00:00,서울시,5,3,0,5,100
2021-06-07 00:00:00,주,2,2,2,0,0
2021-06-07 00:00:00,천,2,2,2,0,0
2021-06-07 00:00:00,강북구,2,1,1,1,50
2021-06-07 00:00:00,서울관악구봉천1동,1,1,1,0,0
2021-06-07 00:00:00,주공아파트,1,1,1,0,0
2021-06-07 00:00:00,광주시,1,1,1,0,0
2021-06-07 00:00:00,인천직할시,3,1,0,3,100
2021-06-07 00:00:00,남,1,1,1,0,0
2021-06-07 00:00:00,산,2,1,2,0,0
2021-06-14 00:00:00,서울특별시,50580,31916,28244,22336,44.16
2021-06-14 00:00:00,경기도,18752,11503,10429,8323,44.38
2021-06-14 00:00:00,인천광역시,3158,1883,1753,1405,44.49
2021-06-14 00:00:00,서울,2281,1629,1372,909,39.85
2021-06-14 00:00:00,충청남도,2194,1348,1227,967,44.07
2021-06-14 00:00:00,경상북도,2043,1137,1095,948,46.4
2021-06-14 00:00:00,강원도,1637,990,941,696,42.52
2021-06-14 00:00:00,,1148,876,734,414,36.06
2021-06-14 00:00:00,경상남도,1590,826,786,804,50.57
2021-06-14 00:00:00,충청북도,1389,810,787,602,43.34
2021-06-14 00:00:00,전라북도,1295,711,707,588,45.41
2021-06-14 00:00:00,부산광역시,1280,687,672,608,47.5
2021-06-14 00:00:00,전라남도,1257,686,671,586,46.62
2021-06-14 00:00:00,대전광역시,1162,629,608,554,47.68
2021-06-14 00:00:00,경기,753,531,420,333,44.22
2021-06-14 00:00:00,대구광역시,953,497,494,459,48.16
2021-06-14 00:00:00,광주광역시,805,432,398,407,50.56
2021-06-14 00:00:00,제주특별자치도,701,371,367,334,47.65
2021-06-14 00:00:00,울산광역시,541,291,275,266,49.17
2021-06-14 00:00:00,세종특별자치시,388,230,219,169,43.56
2021-06-14 00:00:00,인천광역,151,94,66,85,56.29
2021-06-14 00:00:00,인천,102,71,68,34,33.33
2021-06-14 00:00:00,경북,88,52,46,42,47.73
2021-06-14 00:00:00,충남,80,48,47,33,41.25
2021-06-14 00:00:00,경남,56,32,31,25,44.64
2021-06-14 00:00:00,강원,41,30,21,20,48.78
2021-06-14 00:00:00,전남,40,26,21,19,47.5
2021-06-14 00:00:00,대구광역,42,25,23,19,45.24
2021-06-14 00:00:00,전북,39,25,20,19,48.72
2021-06-14 00:00:00,충북,32,25,17,15,46.88
2021-06-14 00:00:00,대전,32,22,16,16,50
2021-06-14 00:00:00,부산광역,38,21,18,20,52.63
2021-06-14 00:00:00,부산,36,21,19,17,47.22
2021-06-14 00:00:00,대구,25,18,9,16,64
2021-06-14 00:00:00,대전광역,25,17,12,13,52
2021-06-14 00:00:00,★★★★★★★★,28,16,11,17,60.71
2021-06-14 00:00:00,광주광역,20,15,11,9,45
2021-06-14 00:00:00,제주도,31,14,14,17,54.84
2021-06-14 00:00:00,서울강북구,18,13,11,7,38.89
2021-06-14 00:00:00,광주,11,9,10,1,9.09
2021-06-14 00:00:00,울산광역,14,9,7,7,50
2021-06-14 00:00:00,울산,18,8,10,8,44.44
2021-06-14 00:00:00,울,6,6,4,2,33.33
2021-06-14 00:00:00,제주,8,5,5,3,37.5
2021-06-14 00:00:00,기,6,2,3,3,50
2021-06-14 00:00:00,서울시,2,2,1,1,50
2021-06-14 00:00:00,광주동구소태동,1,1,1,0,0
2021-06-14 00:00:00,남,2,1,1,1,50
2021-06-14 00:00:00,대동@,1,1,1,0,0
2021-06-14 00:00:00,강서구,1,1,1,0,0
2021-06-14 00:00:00,광주시,2,1,1,1,50
2021-06-14 00:00:00,강북구,1,1,1,0,0
2021-06-14 00:00:00,북,1,1,1,0,0
2021-06-14 00:00:00,산,1,1,1,0,0
2021-06-14 00:00:00,주공아파트,1,1,1,0,0
2021-06-14 00:00:00,인천직할시,1,1,1,0,0
2021-06-21 00:00:00,서울특별시,50832,32120,28488,22344,43.96
2021-06-21 00:00:00,경기도,18756,11650,10611,8145,43.43
2021-06-21 00:00:00,인천광역시,3046,1795,1667,1379,45.27
2021-06-21 00:00:00,서울,2318,1610,1378,940,40.55
2021-06-21 00:00:00,충청남도,2259,1380,1281,978,43.29
2021-06-21 00:00:00,경상북도,2051,1162,1096,955,46.56
2021-06-21 00:00:00,강원도,1868,1106,1014,854,45.72
2021-06-21 00:00:00,경상남도,1717,923,845,872,50.79
2021-06-21 00:00:00,충청북도,1478,870,830,648,43.84
2021-06-21 00:00:00,,1105,869,741,364,32.94
2021-06-21 00:00:00,전라남도,1299,752,695,604,46.5
2021-06-21 00:00:00,부산광역시,1337,749,701,636,47.57
2021-06-21 00:00:00,전라북도,1308,731,737,571,43.65
2021-06-21 00:00:00,대전광역시,1160,658,659,501,43.19
2021-06-21 00:00:00,대구광역시,991,540,528,463,46.72
2021-06-21 00:00:00,경기,736,524,431,305,41.44
2021-06-21 00:00:00,광주광역시,784,429,402,382,48.72
2021-06-21 00:00:00,제주특별자치도,686,372,363,323,47.08
2021-06-21 00:00:00,울산광역시,585,293,296,289,49.4
2021-06-21 00:00:00,세종특별자치시,400,228,211,189,47.25
2021-06-21 00:00:00,인천광역,109,80,71,38,34.86
2021-06-21 00:00:00,경북,70,51,40,30,42.86
2021-06-21 00:00:00,인천,71,51,40,31,43.66
2021-06-21 00:00:00,충남,70,47,36,34,48.57
2021-06-21 00:00:00,경남,61,39,24,37,60.66
2021-06-21 00:00:00,전북,70,39,38,32,45.71
2021-06-21 00:00:00,충북,56,38,39,17,30.36
2021-06-21 00:00:00,강원,43,33,26,17,39.53
2021-06-21 00:00:00,전남,39,28,20,19,48.72
2021-06-21 00:00:00,광주광역,34,24,18,16,47.06
2021-06-21 00:00:00,부산광역,31,21,13,18,58.06
2021-06-21 00:00:00,대구광역,25,19,15,10,40
2021-06-21 00:00:00,대전,29,19,24,5,17.24
2021-06-21 00:00:00,대전광역,21,18,14,7,33.33
2021-06-21 00:00:00,대구,24,16,12,12,50
2021-06-21 00:00:00,광주,23,15,13,10,43.48
2021-06-21 00:00:00,제주도,20,15,12,8,40
2021-06-21 00:00:00,★★★★★★★★,16,14,12,4,25
2021-06-21 00:00:00,울산,22,13,9,13,59.09
2021-06-21 00:00:00,부산,16,11,6,10,62.5
2021-06-21 00:00:00,서울강북구,18,10,7,11,61.11
2021-06-21 00:00:00,울,12,9,11,1,8.33
2021-06-21 00:00:00,울산광역,11,8,7,4,36.36
2021-06-21 00:00:00,제주,11,7,8,3,27.27
2021-06-21 00:00:00,기,4,4,3,1,25
2021-06-21 00:00:00,경기도화성시송산동,1,1,0,1,100
2021-06-21 00:00:00,전,2,1,0,2,100
2021-06-21 00:00:00,남,1,1,0,1,100
2021-06-21 00:00:00,산,1,1,0,1,100
2021-06-21 00:00:00,북,3,1,0,3,100
2021-06-21 00:00:00,서울시,2,1,1,1,50
2021-06-28 00:00:00,서울특별시,49132,31174,27000,22132,45.05
2021-06-28 00:00:00,경기도,18285,11304,10023,8262,45.18
2021-06-28 00:00:00,인천광역시,3230,1893,1710,1520,47.06
2021-06-28 00:00:00,서울,2393,1669,1390,1003,41.91
2021-06-28 00:00:00,충청남도,2166,1287,1166,1000,46.17
2021-06-28 00:00:00,경상북도,2041,1157,1080,961,47.08
2021-06-28 00:00:00,강원도,1715,1000,897,818,47.7
2021-06-28 00:00:00,,1171,877,831,340,29.04
2021-06-28 00:00:00,경상남도,1493,831,785,708,47.42
2021-06-28 00:00:00,충청북도,1356,815,795,561,41.37
2021-06-28 00:00:00,전라남도,1372,729,687,685,49.93
2021-06-28 00:00:00,부산광역시,1311,726,647,664,50.65
2021-06-28 00:00:00,전라북도,1189,693,645,544,45.75
2021-06-28 00:00:00,대전광역시,1096,620,570,526,47.99
2021-06-28 00:00:00,대구광역시,949,544,501,448,47.21
2021-06-28 00:00:00,경기,717,496,395,322,44.91
2021-06-28 00:00:00,광주광역시,733,402,391,342,46.66
2021-06-28 00:00:00,제주특별자치도,735,379,368,367,49.93
2021-06-28 00:00:00,울산광역시,465,261,253,212,45.59
2021-06-28 00:00:00,세종특별자치시,330,210,183,147,44.55
2021-06-28 00:00:00,인천광역,108,73,57,51,47.22
2021-06-28 00:00:00,인천,99,63,48,51,51.52
2021-06-28 00:00:00,충남,86,53,38,48,55.81
2021-06-28 00:00:00,경남,81,52,50,31,38.27
2021-06-28 00:00:00,강원,67,43,29,38,56.72
2021-06-28 00:00:00,경북,60,43,33,27,45
2021-06-28 00:00:00,광주광역,35,28,26,9,25.71
2021-06-28 00:00:00,전남,39,28,17,22,56.41
2021-06-28 00:00:00,전북,44,27,21,23,52.27
2021-06-28 00:00:00,부산광역,50,27,20,30,60
2021-06-28 00:00:00,★★★★★★★★,29,23,12,17,58.62
2021-06-28 00:00:00,대전광역,36,22,16,20,55.56
2021-06-28 00:00:00,광주,36,20,24,12,33.33
2021-06-28 00:00:00,충북,30,19,10,20,66.67
2021-06-28 00:00:00,부산,29,18,15,14,48.28
2021-06-28 00:00:00,대전,24,16,10,14,58.33
2021-06-28 00:00:00,울산,21,12,10,11,52.38
2021-06-28 00:00:00,서울강북구,15,11,9,6,40
2021-06-28 00:00:00,대구,22,11,11,11,50
2021-06-28 00:00:00,울산광역,14,10,7,7,50
2021-06-28 00:00:00,제주도,19,9,10,9,47.37
2021-06-28 00:00:00,대구광역,10,9,6,4,40
2021-06-28 00:00:00,울,9,8,5,4,44.44
2021-06-28 00:00:00,제주,11,6,7,4,36.36
2021-06-28 00:00:00,서울시,3,3,2,1,33.33
2021-06-28 00:00:00,기,6,3,3,3,50
2021-06-28 00:00:00,산,3,2,3,0,0
2021-06-28 00:00:00,남,5,2,2,3,60
2021-06-28 00:00:00,주,1,1,1,0,0
2021-06-28 00:00:00,전,1,1,1,0,0
2021-06-28 00:00:00,북,3,1,1,2,66.67
2021-07-05 00:00:00,서울특별시,50378,31959,27741,22637,44.93
2021-07-05 00:00:00,경기도,17994,11172,9970,8024,44.59
2021-07-05 00:00:00,인천광역시,3238,1941,1772,1466,45.27
2021-07-05 00:00:00,서울,2373,1666,1295,1078,45.43
2021-07-05 00:00:00,충청남도,2208,1316,1222,986,44.66
2021-07-05 00:00:00,경상북도,2058,1167,1105,953,46.31
2021-07-05 00:00:00,강원도,1648,982,864,784,47.57
2021-07-05 00:00:00,,1213,941,793,420,34.62
2021-07-05 00:00:00,경상남도,1533,857,788,745,48.6
2021-07-05 00:00:00,충청북도,1360,805,726,634,46.62
2021-07-05 00:00:00,전라북도,1331,769,719,612,45.98
2021-07-05 00:00:00,전라남도,1313,712,705,608,46.31
2021-07-05 00:00:00,부산광역시,1273,702,634,639,50.2
2021-07-05 00:00:00,대전광역시,1156,652,613,543,46.97
2021-07-05 00:00:00,대구광역시,960,545,481,479,49.9
2021-07-05 00:00:00,경기,728,525,405,323,44.37
2021-07-05 00:00:00,광주광역시,829,469,434,395,47.65
2021-07-05 00:00:00,제주특별자치도,635,337,341,294,46.3
2021-07-05 00:00:00,울산광역시,568,307,282,286,50.35
2021-07-05 00:00:00,세종특별자치시,385,236,206,179,46.49
2021-07-05 00:00:00,인천,89,64,48,41,46.07
2021-07-05 00:00:00,충남,89,63,51,38,42.7
2021-07-05 00:00:00,인천광역,80,63,47,33,41.25
2021-07-05 00:00:00,경북,76,54,47,29,38.16
2021-07-05 00:00:00,강원,68,46,46,22,32.35
2021-07-05 00:00:00,경남,57,40,27,30,52.63
2021-07-05 00:00:00,전남,42,31,22,20,47.62
2021-07-05 00:00:00,★★★★★★★★,40,31,23,17,42.5
2021-07-05 00:00:00,충북,31,28,23,8,25.81
2021-07-05 00:00:00,전북,43,26,29,14,32.56
2021-07-05 00:00:00,부산,37,25,17,20,54.05
2021-07-05 00:00:00,부산광역,35,24,20,15,42.86
2021-07-05 00:00:00,광주광역,39,24,17,22,56.41
2021-07-05 00:00:00,대전,33,22,17,16,48.48
2021-07-05 00:00:00,대전광역,30,20,17,13,43.33
2021-07-05 00:00:00,광주,24,18,19,5,20.83
2021-07-05 00:00:00,대구,28,17,13,15,53.57
2021-07-05 00:00:00,대구광역,25,16,10,15,60
2021-07-05 00:00:00,서울강북구,18,14,15,3,16.67
2021-07-05 00:00:00,울산,19,12,10,9,47.37
2021-07-05 00:00:00,제주도,14,10,6,8,57.14
2021-07-05 00:00:00,울,11,10,7,4,36.36
2021-07-05 00:00:00,울산광역,11,9,6,5,45.45
2021-07-05 00:00:00,제주,15,8,6,9,60
2021-07-05 00:00:00,기,8,6,7,1,12.5
2021-07-05 00:00:00,서울시,3,3,2,1,33.33
2021-07-05 00:00:00,남,4,2,2,2,50
2021-07-05 00:00:00,서초구,1,1,0,1,100
2021-07-05 00:00:00,부산시,1,1,1,0,0
2021-07-05 00:00:00,경기용인시풍덕천2동,1,1,1,0,0
2021-07-05 00:00:00,인천직할시,1,1,0,1,100
2021-07-05 00:00:00,전남여수시여서동,3,1,1,2,66.67
2021-07-05 00:00:00,천,1,1,1,0,0
2021-07-12 00:00:00,서울특별시,51613,32465,28775,22838,44.25
2021-07-12 00:00:00,경기도,18893,11656,10559,8334,44.11
2021-07-12 00:00:00,인천광역시,3301,1942,1704,1597,48.38
2021-07-12 00:00:00,서울,2396,1710,1395,1001,41.78
2021-07-12 00:00:00,충청남도,2264,1325,1245,1019,45.01
2021-07-12 00:00:00,경상북도,1927,1094,1031,896,46.5
2021-07-12 00:00:00,강원도,1743,1024,951,792,45.44
2021-07-12 00:00:00,,1166,904,798,368,31.56
2021-07-12 00:00:00,경상남도,1651,902,846,805,48.76
2021-07-12 00:00:00,충청북도,1458,841,793,665,45.61
2021-07-12 00:00:00,전라남도,1426,792,748,678,47.55
2021-07-12 00:00:00,전라북도,1218,705,656,562,46.14
2021-07-12 00:00:00,부산광역시,1301,703,681,620,47.66
2021-07-12 00:00:00,대전광역시,1205,651,615,590,48.96
2021-07-12 00:00:00,대구광역시,886,516,453,433,48.87
2021-07-12 00:00:00,경기,708,500,378,330,46.61
2021-07-12 00:00:00,광주광역시,783,427,387,396,50.57
2021-07-12 00:00:00,제주특별자치도,668,350,357,311,46.56
2021-07-12 00:00:00,울산광역시,462,254,245,217,46.97
2021-07-12 00:00:00,세종특별자치시,363,210,183,180,49.59
2021-07-12 00:00:00,인천광역,114,82,62,52,45.61
2021-07-12 00:00:00,인천,72,54,48,24,33.33
2021-07-12 00:00:00,충남,78,53,40,38,48.72
2021-07-12 00:00:00,강원,69,40,33,36,52.17
2021-07-12 00:00:00,경북,61,40,30,31,50.82
2021-07-12 00:00:00,전북,43,29,22,21,48.84
2021-07-12 00:00:00,경남,41,27,23,18,43.9
2021-07-12 00:00:00,광주광역,48,26,22,26,54.17
2021-07-12 00:00:00,부산광역,38,26,15,23,60.53
2021-07-12 00:00:00,전남,42,25,18,24,57.14
2021-07-12 00:00:00,부산,37,24,13,24,64.86
2021-07-12 00:00:00,충북,28,23,20,8,28.57
2021-07-12 00:00:00,★★★★★★★★,23,19,13,10,43.48
2021-07-12 00:00:00,대전,26,18,16,10,38.46
2021-07-12 00:00:00,광주,31,17,10,21,67.74
2021-07-12 00:00:00,대전광역,22,17,14,8,36.36
2021-07-12 00:00:00,대구광역,19,15,13,6,31.58
2021-07-12 00:00:00,대구,18,15,12,6,33.33
2021-07-12 00:00:00,울산,14,11,8,6,42.86
2021-07-12 00:00:00,울,12,10,8,4,33.33
2021-07-12 00:00:00,서울강북구,9,8,6,3,33.33
2021-07-12 00:00:00,제주,16,8,10,6,37.5
2021-07-12 00:00:00,제주도,11,7,7,4,36.36
2021-07-12 00:00:00,서울시,4,4,2,2,50
2021-07-12 00:00:00,울산광역,5,4,2,3,60
2021-07-12 00:00:00,기,3,3,1,2,66.67
2021-07-12 00:00:00,강북구,2,2,2,0,0
2021-07-12 00:00:00,남,1,1,1,0,0
2021-07-12 00:00:00,전,2,1,0,2,100
2021-07-12 00:00:00,서대문구,1,1,1,0,0
2021-07-12 00:00:00,주공아파트,1,1,1,0,0
2021-07-19 00:00:00,서울특별시,52754,32562,29206,23548,44.64
2021-07-19 00:00:00,경기도,18777,11632,10464,8313,44.27
2021-07-19 00:00:00,인천광역시,3214,1911,1713,1501,46.7
2021-07-19 00:00:00,서울,2456,1683,1404,1052,42.83
2021-07-19 00:00:00,충청남도,2238,1310,1259,979,43.74
2021-07-19 00:00:00,경상북도,1987,1141,1018,969,48.77
2021-07-19 00:00:00,강원도,1722,1032,944,778,45.18
2021-07-19 00:00:00,,1174,939,786,388,33.05
2021-07-19 00:00:00,경상남도,1648,889,782,866,52.55
2021-07-19 00:00:00,충청북도,1482,860,839,643,43.39
2021-07-19 00:00:00,전라남도,1282,728,682,600,46.8
2021-07-19 00:00:00,부산광역시,1430,723,711,719,50.28
2021-07-19 00:00:00,전라북도,1250,720,665,585,46.8
2021-07-19 00:00:00,대전광역시,1169,671,628,541,46.28
2021-07-19 00:00:00,경기,750,527,420,330,44
2021-07-19 00:00:00,대구광역시,930,506,493,437,46.99
2021-07-19 00:00:00,광주광역시,801,443,412,389,48.56
2021-07-19 00:00:00,제주특별자치도,712,384,394,318,44.66
2021-07-19 00:00:00,울산광역시,537,279,282,255,47.49
2021-07-19 00:00:00,세종특별자치시,413,246,220,193,46.73
2021-07-19 00:00:00,인천광역,129,91,79,50,38.76
2021-07-19 00:00:00,인천,82,53,40,42,51.22
2021-07-19 00:00:00,충남,75,52,42,33,44
2021-07-19 00:00:00,경북,59,49,38,21,35.59
2021-07-19 00:00:00,충북,70,42,32,38,54.29
2021-07-19 00:00:00,강원,66,42,36,30,45.45
2021-07-19 00:00:00,경남,53,31,19,34,64.15
2021-07-19 00:00:00,부산,43,27,21,22,51.16
2021-07-19 00:00:00,★★★★★★★★,33,26,18,15,45.45
2021-07-19 00:00:00,전북,39,26,25,14,35.9
2021-07-19 00:00:00,광주광역,29,24,17,12,41.38
2021-07-19 00:00:00,대전,37,23,14,23,62.16
2021-07-19 00:00:00,광주,35,22,19,16,45.71
2021-07-19 00:00:00,부산광역,32,21,16,16,50
2021-07-19 00:00:00,전남,25,17,15,10,40
2021-07-19 00:00:00,대전광역,19,17,16,3,15.79
2021-07-19 00:00:00,대구광역,18,14,11,7,38.89
2021-07-19 00:00:00,제주,27,14,13,14,51.85
2021-07-19 00:00:00,울산광역,13,10,8,5,38.46
2021-07-19 00:00:00,대구,18,9,8,10,55.56
2021-07-19 00:00:00,제주도,13,9,7,6,46.15
2021-07-19 00:00:00,서울강북구,10,7,7,3,30
2021-07-19 00:00:00,울,7,7,6,1,14.29
2021-07-19 00:00:00,울산,7,5,5,2,28.57
2021-07-19 00:00:00,남,5,3,3,2,40
2021-07-19 00:00:00,강북구,2,2,2,0,0
2021-07-19 00:00:00,서울시,2,2,1,1,50
2021-07-19 00:00:00,전,2,2,2,0,0
2021-07-19 00:00:00,광주시,2,1,1,1,50
2021-07-19 00:00:00,원,1,1,1,0,0
2021-07-19 00:00:00,서울관악구봉천1동,1,1,1,0,0
2021-07-19 00:00:00,전남여수시여서동,1,1,1,0,0
2021-07-19 00:00:00,북,3,1,1,2,66.67
2021-07-19 00:00:00,천,1,1,1,0,0
2021-07-19 00:00:00,기,1,1,1,0,0
2021-07-26 00:00:00,서울특별시,49158,30985,27426,21732,44.21
2021-07-26 00:00:00,경기도,18033,11188,10106,7927,43.96
2021-07-26 00:00:00,인천광역시,3131,1907,1722,1409,45
2021-07-26 00:00:00,서울,2250,1625,1315,935,41.56
2021-07-26 00:00:00,충청남도,2158,1313,1168,990,45.88
2021-07-26 00:00:00,경상북도,1901,1104,1011,890,46.82
2021-07-26 00:00:00,강원도,1713,1017,923,790,46.12
2021-07-26 00:00:00,,1143,889,762,381,33.33
2021-07-26 00:00:00,경상남도,1600,884,828,772,48.25
2021-07-26 00:00:00,충청북도,1349,815,763,586,43.44
2021-07-26 00:00:00,전라북도,1297,748,675,622,47.96
2021-07-26 00:00:00,부산광역시,1347,701,673,674,50.04
2021-07-26 00:00:00,대전광역시,1206,686,615,591,49
2021-07-26 00:00:00,전라남도,1199,675,645,554,46.21
2021-07-26 00:00:00,경기,778,518,380,398,51.16
2021-07-26 00:00:00,대구광역시,849,512,447,402,47.35
2021-07-26 00:00:00,광주광역시,752,440,374,378,50.27
2021-07-26 00:00:00,제주특별자치도,617,340,334,283,45.87
2021-07-26 00:00:00,울산광역시,491,279,263,228,46.44
2021-07-26 00:00:00,세종특별자치시,381,226,224,157,41.21
2021-07-26 00:00:00,인천광역,132,90,69,63,47.73
2021-07-26 00:00:00,인천,108,76,60,48,44.44
2021-07-26 00:00:00,충남,81,57,47,34,41.98
2021-07-26 00:00:00,충북,61,43,28,33,54.1
2021-07-26 00:00:00,강원,48,34,26,22,45.83
2021-07-26 00:00:00,경북,54,32,27,27,50
2021-07-26 00:00:00,경남,46,31,25,21,45.65
2021-07-26 00:00:00,★★★★★★★★,36,31,22,14,38.89
2021-07-26 00:00:00,부산광역,42,29,17,25,59.52
2021-07-26 00:00:00,광주광역,50,27,21,29,58
2021-07-26 00:00:00,대전광역,33,23,16,17,51.52
2021-07-26 00:00:00,전남,33,23,16,17,51.52
2021-07-26 00:00:00,부산,28,19,14,14,50
2021-07-26 00:00:00,대구광역,28,19,16,12,42.86
2021-07-26 00:00:00,전북,24,19,13,11,45.83
2021-07-26 00:00:00,대전,22,16,12,10,45.45
2021-07-26 00:00:00,대구,24,14,14,10,41.67
2021-07-26 00:00:00,광주,17,12,5,12,70.59
2021-07-26 00:00:00,제주도,13,8,6,7,53.85
2021-07-26 00:00:00,서울강북구,12,7,3,9,75
2021-07-26 00:00:00,울,7,6,5,2,28.57
2021-07-26 00:00:00,울산,8,6,4,4,50
2021-07-26 00:00:00,제주,10,5,4,6,60
2021-07-26 00:00:00,기,6,4,2,4,66.67
2021-07-26 00:00:00,서울시,3,3,0,3,100
2021-07-26 00:00:00,산,5,3,3,2,40
2021-07-26 00:00:00,울산광역,4,3,4,0,0
2021-07-26 00:00:00,(주소불명)1119,1,1,0,1,100
2021-07-26 00:00:00,남동구만수2동,2,1,1,1,50
2021-07-26 00:00:00,강북구,2,1,1,1,50
2021-07-26 00:00:00,경기용인시풍덕천2동,1,1,1,0,0
2021-07-26 00:00:00,전,1,1,0,1,100
2021-07-26 00:00:00,남,1,1,1,0,0
2021-07-26 00:00:00,원,2,1,0,2,100
2021-07-26 00:00:00,천,1,1,1,0,0
