"MED_DEPT_CD","MED_DEPT_NM","ROWCNT","PCNT","MED_Y_CNT","MED_N_CNT","MED_N_RATE"
DR,영상의학과,39756,32935,634,39122,98.41
IMC,순환기내과,15700,12539,11492,4208,26.8
NR,신경과,13929,11467,10373,3556,25.53
IMG,소화기내과,16314,10670,8502,7812,47.89
OT,안과,11198,8558,8781,2417,21.58
IME,내분비대사내과,12416,8442,7212,5204,41.91
IMOC1,종양내과센터종양내과,17841,8039,9901,7940,44.5
NP,정신건강의학과,9290,7532,7456,1834,19.74
IMN,신장내과,12698,7033,8154,4544,35.79
IMR,호흡기내과,8952,6201,4194,4758,53.15
OG,산부인과,11403,6011,6750,4653,40.81
BCCGS,유방센터외과,8993,5278,4509,4484,49.86
HCS,강남센터,5499,5190,3894,1605,29.19
OS,정형외과,6542,5169,4434,2108,32.22
HCSO,강남클리닉,8091,4923,1103,6988,86.37
DM,피부과,6239,4822,5080,1159,18.58
IMI,감염내과,5238,4414,4789,449,8.57
IMJ,류마티스내과,5479,4334,4184,1295,23.64
MCI,제증명발급,4614,4297,194,4420,95.8
NM,핵의학과,4860,4201,652,4208,86.58
FM,가정의학과,5202,4086,3693,1509,29.01
IMZ,내과(일반),4432,4028,710,3722,83.98
UR,비뇨의학과,5721,3958,2875,2846,49.75
NS,신경외과,5278,3782,3013,2265,42.91
OL,이비인후과,5006,3624,2981,2025,40.45
CVC,심혈관센터,3668,3087,6,3662,99.84
EMO,응급의학과(EMO),3971,2945,84,3887,97.88
UPCUR,비뇨암센터비뇨의학과,4362,2812,2696,1666,38.19
POT,소아안과,3140,2702,2689,451,14.36
CP,진단검사의학과,3156,2592,2468,688,21.8
LIIMG,간암센터소화기내과,3687,2315,1942,1745,47.33
TCIME,갑상선센터내분비대사내과,3627,2303,1701,1926,53.1
CHIMH,혈액암센터혈액종양내과,4558,2231,2580,1978,43.4
RH,재활의학과,4037,2180,1405,2632,65.2
PEEM,소아청소년과(내분비대사),2854,2118,1799,1055,36.97
PENR,소아청소년과(신경),2450,2045,1928,522,21.31
TS,흉부외과,3030,2036,1862,1168,38.55
TVS,이식혈관외과,2756,1984,1938,818,29.68
ANO2,통증센터,2417,1944,2031,386,15.97
HBPS,간담췌외과,2984,1891,1603,1381,46.28
IMA,알레르기내과,2005,1768,1539,466,23.24
CTC,임상시험센터외래,2325,1748,1980,345,14.84
PEDC,소아청소년과(심장),2050,1631,1411,639,31.17
CCGS,대장암센터외과,2300,1630,1474,826,35.91
CHP,소아정신과,2133,1621,1667,466,21.85
POS,소아정형외과,1966,1584,1480,486,24.72
ROCTR,방사선종양센터방사선종양학과,1894,1563,1451,443,23.39
HPC,건강증진센터,2184,1480,1619,565,25.87
PED,소아청소년과,1763,1458,12,1751,99.32
LUTS,폐암센터흉부외과,2187,1430,1286,901,41.2
CCTCO,종양임상시험센터외래,3281,1423,2337,944,28.77
IMH,혈액종양내과,2175,1394,962,1213,55.77
LUIMR,폐암센터호흡기내과,1934,1292,1116,818,42.3
GYCOG,부인암센터산부인과,1687,1283,1211,476,28.22
TOHOL,갑상선/구강/두경부암센터이비인후과,1626,1187,1042,584,35.92
SLEG,소화기내시경센터(암병원),1331,1178,590,741,55.67
NUGDW,암병원 항암낮병동,1688,1154,1685,3,0.18
GAGS,위암센터외과,1799,1064,873,926,51.47
TCGS,갑상선센터외과,1814,1041,892,922,50.83
POL,소아이비인후과,1382,1023,918,464,33.57
PEHOO,소아청소년암센터외래,2610,994,1814,796,30.5
EMPO,소아응급(EMPO),1148,982,10,1138,99.13
PS,성형외과,1685,962,1280,405,24.04
PENP,소아청소년과(신장),1362,945,918,444,32.6
PNS,소아신경외과,1179,901,764,415,35.2
PDM,소아피부과,951,897,814,137,14.41
PUR,소아비뇨의학과,1063,883,823,240,22.58
TRC,방사선치료센터,5827,878,5321,506,8.68
ESCOS,근골격종양센터정형외과,1278,875,787,491,38.42
BSCNS,뇌종양센터신경외과,1232,836,670,562,45.62
PBIMG,췌장/담도암센터소화기내과,2125,808,1021,1104,51.95
CRS,대장항문외과,1035,761,439,596,57.58
PEGI,소아청소년과(소화기영양),1124,760,686,438,38.97
PRH,소아재활의학과,1286,712,535,751,58.4
CVCC,(성남)생활치료센터,3727,627,1798,1929,51.76
CCIMG,대장암센터소화기내과,834,607,482,352,42.21
OSHS,정형(수부)외과,713,598,552,161,22.58
PDS,소아외과,1145,589,480,665,58.08
HIP,직원신체검사,565,564,18,547,96.81
GAIMG,위암센터소화기내과,858,553,484,374,43.59
PMCNP,암통합케어센터정신건강센터,548,505,470,78,14.23
PBGS,췌장/담도암센터외과,709,492,358,351,49.51
CICDR,종양영상센터영상의학과,637,477,460,177,27.79
PDID,소아청소년과(감염),601,475,494,107,17.8
PMCRH,암통합케어센터암재활센터,1316,434,308,1008,76.6
PEIR,소아청소년과(면역류마티스),543,432,415,128,23.57
PTS,소아흉부외과,554,426,359,195,35.2
PEDZ,소아청소년과(일반),488,417,313,175,35.86
HPFM2,암건강증진센터가정의학과(대한외래),617,415,330,287,46.52
PENE,소아청소년과(신생아),537,407,364,173,32.22
PPS,소아성형외과,501,397,357,144,28.74
PARD,소아청소년과(호흡알레르기),459,395,340,119,25.93
PEF0,소아청소년과(전임의),964,394,369,595,61.72
LIGS,간암센터외과,497,370,326,171,34.41
HPFM1,암건강증진센터가정의학과,494,367,300,194,39.27
STCNS,척추종양센터신경외과,443,363,313,130,29.35
GSZ,외과(일반),484,355,387,97,20.04
EQLC,감성센터,415,342,302,113,27.23
STCOS,척추종양센터정형외과,376,333,265,111,29.52
PEGD,소아청소년과(유전),382,331,310,72,18.85
SCCDM,피부암/항암제특이반응센터피부과,395,322,339,56,14.18
HSIMC,(강남)순환기내과,352,308,287,65,18.47
HSIME,(강남)내분비대사내과,354,285,248,106,29.94
IMHM,내과(입원의학),408,255,33,375,91.91
OTS,장기이식센터,318,255,15,303,95.28
POSHS,소아정형(수부)외과,271,248,240,31,11.44
HSFM,(강남)가정의학과,281,245,221,60,21.35
BCCPS,유방센터성형외과,248,222,216,32,12.9
DMC,약물안전센터,247,216,216,31,12.55
BSCNR,뇌종양센터신경과,284,214,189,95,33.45
IHC,국제진료센터,244,210,215,29,11.89
CPCC,(성남)소아생활치료센터,1338,201,593,745,55.68
PCTC,소아임상시험실,266,196,213,53,19.92
PEHOD,소아청소년암센터낮병동,646,193,601,45,6.97
COCC,통합케어클리닉,454,191,428,26,5.73
GIS,위장관외과,302,185,86,216,71.52
TCNM,갑상선센터핵의학과,371,183,140,231,62.26
NB,신생아실(소아청소년과),312,171,0,312,100
POG,소아청소년여성클리닉,216,167,129,87,40.28
PA,병리과,164,162,162,2,1.22
NPPSG,수면의학센터,173,155,0,173,100
PPCT,소아청소년과(완화의료),189,137,157,32,16.93
HSNP,(강남)정신건강의학과,149,135,141,8,5.37
HPC99,건강의학과,147,126,19,128,87.07
TCDR,갑상선센터영상의학과,140,120,105,35,25
RHMSK,근골격재활시술,129,116,112,17,13.18
HSIMG,(강남)소화기내과,122,109,85,37,30.33
PHCT,소아재택의료,242,107,222,20,8.26
PEHO,소아청소년과(혈액종양),289,106,18,271,93.77
HSIMA,(강남)알레르기내과,116,105,111,5,4.31
ENVR,환경의학클리닉,105,102,102,3,2.86
HSNR,(강남)신경과,96,90,92,4,4.17
CHO1,조혈모세포이식외래(암병원),174,88,114,60,34.48
HP,완화의료·임상윤리센터,104,87,87,17,16.35
AN,마취통증의학과,85,85,79,6,7.06
BCCRH,유방센터재활의학과,310,73,47,263,84.84
HSOT,(강남)안과,84,65,60,24,28.57
ICS,감염관리센터,84,61,51,33,39.29
WMHE,일마음건강클리닉,81,60,74,7,8.64
PCBS,암맞춤치료센터유방외과,60,60,52,8,13.33
BSCC1,뇌종양센터협진(신경외과),73,53,28,45,61.64
HSUR,(강남)비뇨의학과,65,53,43,22,33.85
COCC,공공진료센터 통합케어클리닉,56,49,52,4,7.14
TMUH2,(원격진료)피부과,44,44,44,0,0
GMPED,임상유전체의학과(소아청소년과),41,40,41,0,0
PEIC,소아청소년과(중환자),45,39,35,10,22.22
PDR,소아영상의학과,42,39,1,41,97.62
BSCC2,뇌종양센터협진(방사선종양학과),50,38,21,29,58
BSCC3,뇌종양센터협진(종양내과),54,36,20,34,62.96
TMUH1,(원격진료)정신과,35,34,35,0,0
PMCCM,암통합케어센터완화의료센터(가정의학과),34,29,0,34,100
GS,외과,28,25,1,27,96.43
PCIMH,암맞춤치료센터혈액종양내과,41,23,16,25,60.98
CPU,임상약리학과,24,23,24,0,0
TRS,외상외과,27,16,10,17,62.96
WMHE,공공진료센터 일마음건강클리닉,16,16,16,0,0
NPDCC,정신건강주간치료실,69,15,66,3,4.35
HSDR,(강남)영상의학과,14,14,14,0,0
PMCNR,암통합케어센터신경센터,17,13,1,16,94.12
SMK,금연클리닉,14,13,12,2,14.29
HSRH,(강남)재활의학과,11,11,10,1,9.09
HSGS,(강남)외과,11,10,10,1,9.09
GMNR,임상유전체의학과(신경과),10,9,8,2,20
HSIMN,(강남)신장내과,9,9,9,0,0
PHPC,소아 건강검진,9,9,9,0,0
PTR,소아방사선종양학과,11,7,4,7,63.64
BSCC5,뇌종양센터협진(신경과),6,5,1,5,83.33
GMLM,임상유전체의학과(진단검사의학과),5,5,5,0,0
PCP,소아진단검사의학과,4,4,0,4,100
ICUNS,중환자의학(신경외과),4,4,0,4,100
SCC2,피부암센터협진외래(성형외과),11,3,3,8,72.73
HOHC,가정형 호스피스,8,3,6,2,25
SCC1,피부암센터협진외래(피부과),5,3,5,0,0
CFPS,두개안면기형 협진클리닉(소아성형외과),3,3,3,0,0
PAN,소아마취통증의학과,3,3,0,3,100
CFNS,두개안면기형 협진클리닉(소아신경외과),3,3,2,1,33.33
PEDH,소아청소년과(입원의학),3,3,0,3,100
CFOT,두개안면기형 협진클리닉(소아안과),3,3,3,0,0
SCC6,피부암센터협진외래(병리과),3,3,0,3,100
REDNR,응급의료센터(신경과),5,2,0,5,100
LUCC3,폐암센터협진(종양내과),2,2,2,0,0
ICUGS,중환자의학(외과),2,2,0,2,100
LUCC1,폐암센터협진(흉부외과),2,2,2,0,0
LUCC4,폐암센터협진(방사선종양학과),2,2,2,0,0
LUCC5,폐암센터협진(영상의학과),2,2,2,0,0
STC1,척추종양센터협진(신경외과),4,1,2,2,50
PCIMG,암맞춤치료센터소화기내과,2,1,1,1,50
STC3,척추종양센터협진(혈액종양내과),1,1,1,0,0
STC4,척추종양센터협진(방사선종양학과),1,1,0,1,100
ICUAN,중환자의학(마취통증의학과),1,1,0,1,100
PCCRS,암맞춤치료센터대장항문외과,1,1,1,0,0
PEHO0,소아청소년암센터협진(소아청소년암센터),1,1,0,1,100
PMCPA,암통합케어센터암성통증센터,1,1,0,1,100
PEHO2,소아청소년암센터협진(영상의학과),1,1,0,1,100
HSIMR,(강남)호흡기내과,1,1,1,0,0
STC6,척추종양센터협진(병리과),1,1,0,1,100
ICUEM,중환자의학(응급의학과),1,1,0,1,100
STC5,척추종양센터협진(영상의학과),1,1,1,0,0
SCC4,피부암센터협진외래(종양내과),1,1,0,1,100
ENVR,공공진료센터 환경의학클리닉,1,1,0,1,100
GSO1,유방진료실,1,1,0,1,100
LUCC2,폐암센터협진(호흡기내과),1,1,1,0,0
