"DATE","SIDO_ADDR","ROWCNT","PCNT","MED_Y_CNT","MED_N_CNT","MED_N_RATE"
2020-09-28 00:00:00.000,서울특별시,1881,1469,780,1101,58.53
2020-09-28 00:00:00.000,경기도,616,494,240,376,61.04
2020-09-28 00:00:00.000,인천광역시,130,92,48,82,63.08
2020-09-28 00:00:00.000,경상북도,54,47,20,34,62.96
2020-09-28 00:00:00.000,강원도,55,44,19,36,65.45
2020-09-28 00:00:00.000,경상남도,56,43,16,40,71.43
2020-09-28 00:00:00.000,충청남도,54,42,21,33,61.11
2020-09-28 00:00:00.000,부산광역시,48,38,21,27,56.25
2020-09-28 00:00:00.000,전라북도,34,30,17,17,50
2020-09-28 00:00:00.000,대전광역시,38,26,19,19,50
2020-09-28 00:00:00.000,충청북도,31,25,13,18,58.06
2020-09-28 00:00:00.000,전라남도,28,25,12,16,57.14
2020-09-28 00:00:00.000,제주특별자치도,26,18,11,15,57.69
2020-09-28 00:00:00.000,서울,23,18,6,17,73.91
2020-09-28 00:00:00.000,대구광역시,24,18,6,18,75
2020-09-28 00:00:00.000,,38,18,1,37,97.37
2020-09-28 00:00:00.000,울산광역시,18,13,5,13,72.22
2020-09-28 00:00:00.000,광주광역시,15,13,8,7,46.67
2020-09-28 00:00:00.000,세종특별자치시,15,11,8,7,46.67
2020-09-28 00:00:00.000,경기,9,6,2,7,77.78
2020-09-28 00:00:00.000,전북,2,2,2,0,0
2020-09-28 00:00:00.000,경북,3,2,0,3,100
2020-09-28 00:00:00.000,충남,1,1,0,1,100
2020-09-28 00:00:00.000,강원,1,1,0,1,100
2020-09-28 00:00:00.000,인천,1,1,1,0,0
2020-09-28 00:00:00.000,부산광역,1,1,1,0,0
2020-09-28 00:00:00.000,경남,1,1,1,0,0
2020-09-28 00:00:00.000,충북,2,1,0,2,100
2020-10-05 00:00:00.000,서울특별시,44852,28716,25158,19694,43.91
2020-10-05 00:00:00.000,경기도,16659,10329,9228,7431,44.61
2020-10-05 00:00:00.000,인천광역시,2920,1746,1592,1328,45.48
2020-10-05 00:00:00.000,서울,1996,1455,1169,827,41.43
2020-10-05 00:00:00.000,충청남도,1956,1183,1063,893,45.65
2020-10-05 00:00:00.000,경상북도,1812,1066,941,871,48.07
2020-10-05 00:00:00.000,강원도,1566,947,883,683,43.61
2020-10-05 00:00:00.000,경상남도,1484,824,773,711,47.91
2020-10-05 00:00:00.000,충청북도,1283,761,718,565,44.04
2020-10-05 00:00:00.000,,885,702,644,241,27.23
2020-10-05 00:00:00.000,전라남도,1244,670,632,612,49.2
2020-10-05 00:00:00.000,전라북도,1163,666,642,521,44.8
2020-10-05 00:00:00.000,부산광역시,1207,642,638,569,47.14
2020-10-05 00:00:00.000,대전광역시,1091,606,587,504,46.2
2020-10-05 00:00:00.000,경기,671,482,384,287,42.77
2020-10-05 00:00:00.000,대구광역시,790,441,426,364,46.08
2020-10-05 00:00:00.000,광주광역시,747,405,399,348,46.59
2020-10-05 00:00:00.000,제주특별자치도,588,321,309,279,47.45
2020-10-05 00:00:00.000,울산광역시,446,244,220,226,50.67
2020-10-05 00:00:00.000,세종특별자치시,345,207,200,145,42.03
2020-10-05 00:00:00.000,인천광역,111,89,66,45,40.54
2020-10-05 00:00:00.000,인천,74,53,39,35,47.3
2020-10-05 00:00:00.000,충남,69,52,38,31,44.93
2020-10-05 00:00:00.000,경북,65,43,30,35,53.85
2020-10-05 00:00:00.000,강원,42,32,21,21,50
2020-10-05 00:00:00.000,충북,45,30,23,22,48.89
2020-10-05 00:00:00.000,전북,40,29,27,13,32.5
2020-10-05 00:00:00.000,전남,40,27,20,20,50
2020-10-05 00:00:00.000,경남,35,25,21,14,40
2020-10-05 00:00:00.000,부산,33,21,16,17,51.52
2020-10-05 00:00:00.000,부산광역,25,17,20,5,20
2020-10-05 00:00:00.000,울산,21,16,13,8,38.1
2020-10-05 00:00:00.000,대전광역,22,16,11,11,50
2020-10-05 00:00:00.000,광주,26,15,10,16,61.54
2020-10-05 00:00:00.000,대구광역,19,14,10,9,47.37
2020-10-05 00:00:00.000,대전,17,14,12,5,29.41
2020-10-05 00:00:00.000,★★★★★★★★,16,12,8,8,50
2020-10-05 00:00:00.000,광주광역,13,11,6,7,53.85
2020-10-05 00:00:00.000,대구,19,11,8,11,57.89
2020-10-05 00:00:00.000,제주,12,7,5,7,58.33
2020-10-05 00:00:00.000,제주도,7,5,5,2,28.57
2020-10-05 00:00:00.000,울,4,4,3,1,25
2020-10-05 00:00:00.000,기,4,3,1,3,75
2020-10-05 00:00:00.000,울산광역,4,3,1,3,75
2020-10-05 00:00:00.000,서울강북구,3,3,2,1,33.33
2020-10-05 00:00:00.000,서울시,4,2,1,3,75
2020-10-05 00:00:00.000,남,3,2,3,0,0
2020-10-05 00:00:00.000,광진구,1,1,1,0,0
2020-10-05 00:00:00.000,경기용인시풍덕천2동,1,1,1,0,0
2020-10-05 00:00:00.000,산,2,1,2,0,0
2020-10-05 00:00:00.000,강북구,1,1,1,0,0
2020-10-05 00:00:00.000,북,1,1,0,1,100
2020-10-12 00:00:00.000,서울특별시,42810,27699,23396,19414,45.35
2020-10-12 00:00:00.000,경기도,15875,10025,8640,7235,45.57
2020-10-12 00:00:00.000,인천광역시,2659,1617,1417,1242,46.71
2020-10-12 00:00:00.000,서울,1942,1419,1064,878,45.21
2020-10-12 00:00:00.000,충청남도,1941,1182,1049,892,45.96
2020-10-12 00:00:00.000,경상북도,1716,1002,897,819,47.73
2020-10-12 00:00:00.000,강원도,1532,916,784,748,48.83
2020-10-12 00:00:00.000,경상남도,1522,850,761,761,50
2020-10-12 00:00:00.000,,1013,793,726,287,28.33
2020-10-12 00:00:00.000,충청북도,1251,746,710,541,43.25
2020-10-12 00:00:00.000,전라남도,1253,697,608,645,51.48
2020-10-12 00:00:00.000,부산광역시,1136,621,582,554,48.77
2020-10-12 00:00:00.000,전라북도,1031,616,503,528,51.21
2020-10-12 00:00:00.000,대전광역시,1029,573,511,518,50.34
2020-10-12 00:00:00.000,경기,642,467,359,283,44.08
2020-10-12 00:00:00.000,대구광역시,749,420,392,357,47.66
2020-10-12 00:00:00.000,광주광역시,719,403,372,347,48.26
2020-10-12 00:00:00.000,제주특별자치도,533,281,270,263,49.34
2020-10-12 00:00:00.000,울산광역시,437,251,233,204,46.68
2020-10-12 00:00:00.000,세종특별자치시,300,183,162,138,46
2020-10-12 00:00:00.000,인천광역,107,83,53,54,50.47
2020-10-12 00:00:00.000,충남,78,59,43,35,44.87
2020-10-12 00:00:00.000,인천,73,58,36,37,50.68
2020-10-12 00:00:00.000,강원,48,36,20,28,58.33
2020-10-12 00:00:00.000,경북,48,34,25,23,47.92
2020-10-12 00:00:00.000,경남,46,32,22,24,52.17
2020-10-12 00:00:00.000,충북,47,27,21,26,55.32
2020-10-12 00:00:00.000,전북,34,26,17,17,50
2020-10-12 00:00:00.000,전남,42,24,24,18,42.86
2020-10-12 00:00:00.000,부산광역,37,23,15,22,59.46
2020-10-12 00:00:00.000,광주광역,31,21,16,15,48.39
2020-10-12 00:00:00.000,대전,37,20,16,21,56.76
2020-10-12 00:00:00.000,부산,23,18,15,8,34.78
2020-10-12 00:00:00.000,대구광역,21,17,15,6,28.57
2020-10-12 00:00:00.000,대전광역,24,17,10,14,58.33
2020-10-12 00:00:00.000,광주,24,14,10,14,58.33
2020-10-12 00:00:00.000,대구,27,14,7,20,74.07
2020-10-12 00:00:00.000,★★★★★★★★,18,13,7,11,61.11
2020-10-12 00:00:00.000,울,15,12,10,5,33.33
2020-10-12 00:00:00.000,울산,13,7,8,5,38.46
2020-10-12 00:00:00.000,울산광역,10,6,4,6,60
2020-10-12 00:00:00.000,서울강북구,6,4,3,3,50
2020-10-12 00:00:00.000,제주도,6,4,1,5,83.33
2020-10-12 00:00:00.000,기,7,4,2,5,71.43
2020-10-12 00:00:00.000,남,4,3,1,3,75
2020-10-12 00:00:00.000,서울시,4,3,3,1,25
2020-10-12 00:00:00.000,제주,6,3,1,5,83.33
2020-10-12 00:00:00.000,세종시,1,1,1,0,0
2020-10-12 00:00:00.000,북,1,1,0,1,100
2020-10-12 00:00:00.000,천,1,1,1,0,0
2020-10-12 00:00:00.000,전,4,1,0,4,100
2020-10-12 00:00:00.000,산,1,1,1,0,0
2020-10-12 00:00:00.000,강북구,1,1,1,0,0
2020-10-12 00:00:00.000,서울관악구봉천1동,1,1,1,0,0
2020-10-19 00:00:00.000,서울특별시,50875,32219,28329,22546,44.32
2020-10-19 00:00:00.000,경기도,18791,11747,10531,8260,43.96
2020-10-19 00:00:00.000,인천광역시,3001,1820,1698,1303,43.42
2020-10-19 00:00:00.000,서울,2476,1759,1430,1046,42.25
2020-10-19 00:00:00.000,충청남도,2225,1354,1194,1031,46.34
2020-10-19 00:00:00.000,,1497,1291,671,826,55.18
2020-10-19 00:00:00.000,경상북도,2015,1161,1052,963,47.79
2020-10-19 00:00:00.000,강원도,1911,1125,1028,883,46.21
2020-10-19 00:00:00.000,경상남도,1685,943,859,826,49.02
2020-10-19 00:00:00.000,충청북도,1547,891,828,719,46.48
2020-10-19 00:00:00.000,전라남도,1391,814,739,652,46.87
2020-10-19 00:00:00.000,전라북도,1270,772,658,612,48.19
2020-10-19 00:00:00.000,부산광역시,1383,758,697,686,49.6
2020-10-19 00:00:00.000,대전광역시,1219,674,677,542,44.46
2020-10-19 00:00:00.000,경기,765,559,426,339,44.31
2020-10-19 00:00:00.000,대구광역시,915,509,497,418,45.68
2020-10-19 00:00:00.000,광주광역시,861,479,434,427,49.59
2020-10-19 00:00:00.000,제주특별자치도,670,362,399,271,40.45
2020-10-19 00:00:00.000,울산광역시,556,313,279,277,49.82
2020-10-19 00:00:00.000,세종특별자치시,379,241,217,162,42.74
2020-10-19 00:00:00.000,인천광역,158,111,91,67,42.41
2020-10-19 00:00:00.000,인천,122,87,72,50,40.98
2020-10-19 00:00:00.000,충남,98,63,46,52,53.06
2020-10-19 00:00:00.000,강원,75,52,35,40,53.33
2020-10-19 00:00:00.000,경북,59,43,37,22,37.29
2020-10-19 00:00:00.000,경남,63,42,32,31,49.21
2020-10-19 00:00:00.000,충북,47,34,27,20,42.55
2020-10-19 00:00:00.000,전남,50,32,25,25,50
2020-10-19 00:00:00.000,부산광역,51,30,25,26,50.98
2020-10-19 00:00:00.000,대전광역,35,28,19,16,45.71
2020-10-19 00:00:00.000,전북,35,24,13,22,62.86
2020-10-19 00:00:00.000,광주광역,35,22,18,17,48.57
2020-10-19 00:00:00.000,대전,31,21,20,11,35.48
2020-10-19 00:00:00.000,★★★★★★★★,24,19,12,12,50
2020-10-19 00:00:00.000,부산,25,19,16,9,36
2020-10-19 00:00:00.000,대구,26,17,13,13,50
2020-10-19 00:00:00.000,대구광역,18,13,9,9,50
2020-10-19 00:00:00.000,광주,23,13,10,13,56.52
2020-10-19 00:00:00.000,제주,16,10,8,8,50
2020-10-19 00:00:00.000,울산,16,10,6,10,62.5
2020-10-19 00:00:00.000,제주도,11,8,4,7,63.64
2020-10-19 00:00:00.000,울,11,8,8,3,27.27
2020-10-19 00:00:00.000,울산광역,7,6,5,2,28.57
2020-10-19 00:00:00.000,서울강북구,7,6,5,2,28.57
2020-10-19 00:00:00.000,기,5,3,3,2,40
2020-10-19 00:00:00.000,남,3,3,3,0,0
2020-10-19 00:00:00.000,천,2,2,1,1,50
2020-10-19 00:00:00.000,산,3,2,3,0,0
2020-10-19 00:00:00.000,서대문구,1,1,1,0,0
2020-10-19 00:00:00.000,전,1,1,1,0,0
2020-10-19 00:00:00.000,서울시,3,1,1,2,66.67
2020-10-19 00:00:00.000,경기용인시풍덕천2동,1,1,1,0,0
2020-10-19 00:00:00.000,북,1,1,1,0,0
2020-10-19 00:00:00.000,인천시,2,1,0,2,100
2020-10-26 00:00:00.000,서울특별시,49334,31294,27473,21861,44.31
2020-10-26 00:00:00.000,경기도,18382,11441,10107,8275,45.02
2020-10-26 00:00:00.000,인천광역시,2955,1771,1619,1336,45.21
2020-10-26 00:00:00.000,서울,2357,1688,1281,1076,45.65
2020-10-26 00:00:00.000,충청남도,2160,1315,1141,1019,47.18
2020-10-26 00:00:00.000,경상북도,1987,1136,1015,972,48.92
2020-10-26 00:00:00.000,강원도,1734,1049,946,788,45.44
2020-10-26 00:00:00.000,경상남도,1553,900,794,759,48.87
2020-10-26 00:00:00.000,충청북도,1424,840,760,664,46.63
2020-10-26 00:00:00.000,,944,777,691,253,26.8
2020-10-26 00:00:00.000,전라남도,1299,761,684,615,47.34
2020-10-26 00:00:00.000,부산광역시,1340,731,683,657,49.03
2020-10-26 00:00:00.000,전라북도,1209,694,624,585,48.39
2020-10-26 00:00:00.000,대전광역시,1144,649,585,559,48.86
2020-10-26 00:00:00.000,경기,812,578,440,372,45.81
2020-10-26 00:00:00.000,대구광역시,894,505,466,428,47.87
2020-10-26 00:00:00.000,광주광역시,876,473,455,421,48.06
2020-10-26 00:00:00.000,제주특별자치도,696,353,361,335,48.13
2020-10-26 00:00:00.000,울산광역시,536,296,284,252,47.01
2020-10-26 00:00:00.000,세종특별자치시,363,222,205,158,43.53
2020-10-26 00:00:00.000,인천광역,130,94,73,57,43.85
2020-10-26 00:00:00.000,인천,80,62,45,35,43.75
2020-10-26 00:00:00.000,경남,88,61,37,51,57.95
2020-10-26 00:00:00.000,충남,95,57,42,53,55.79
2020-10-26 00:00:00.000,경북,74,48,40,34,45.95
2020-10-26 00:00:00.000,강원,67,47,32,35,52.24
2020-10-26 00:00:00.000,충북,53,37,30,23,43.4
2020-10-26 00:00:00.000,부산광역,56,30,27,29,51.79
2020-10-26 00:00:00.000,대전광역,38,28,21,17,44.74
2020-10-26 00:00:00.000,전북,37,23,24,13,35.14
2020-10-26 00:00:00.000,부산,35,22,11,24,68.57
2020-10-26 00:00:00.000,★★★★★★★★,25,22,13,12,48
2020-10-26 00:00:00.000,전남,34,22,18,16,47.06
2020-10-26 00:00:00.000,대구,35,18,15,20,57.14
2020-10-26 00:00:00.000,대전,24,18,11,13,54.17
2020-10-26 00:00:00.000,광주,26,17,16,10,38.46
2020-10-26 00:00:00.000,광주광역,27,17,15,12,44.44
2020-10-26 00:00:00.000,대구광역,26,16,12,14,53.85
2020-10-26 00:00:00.000,제주도,17,12,12,5,29.41
2020-10-26 00:00:00.000,울산,17,12,9,8,47.06
2020-10-26 00:00:00.000,제주,14,11,8,6,42.86
2020-10-26 00:00:00.000,서울강북구,13,11,9,4,30.77
2020-10-26 00:00:00.000,울,12,10,5,7,58.33
2020-10-26 00:00:00.000,울산광역,13,10,8,5,38.46
2020-10-26 00:00:00.000,강북구,3,2,1,2,66.67
2020-10-26 00:00:00.000,강동구,1,1,1,0,0
2020-10-26 00:00:00.000,서울시,1,1,0,1,100
2020-10-26 00:00:00.000,세종시,2,1,2,0,0
2020-10-26 00:00:00.000,경기용인시풍덕천2동,2,1,2,0,0
2020-10-26 00:00:00.000,기,2,1,2,0,0
2020-10-26 00:00:00.000,경기도화성시송산동,2,1,2,0,0
2020-10-26 00:00:00.000,산,2,1,2,0,0
2020-10-26 00:00:00.000,남,1,1,1,0,0
2020-10-26 00:00:00.000,원,2,1,0,2,100
2020-10-26 00:00:00.000,인헌12다길,1,1,1,0,0
2020-11-02 00:00:00.000,서울특별시,50261,31931,27923,22338,44.44
2020-11-02 00:00:00.000,경기도,18515,11539,10161,8354,45.12
2020-11-02 00:00:00.000,인천광역시,2954,1787,1603,1351,45.73
2020-11-02 00:00:00.000,서울,2476,1736,1360,1116,45.07
2020-11-02 00:00:00.000,충청남도,2135,1317,1162,973,45.57
2020-11-02 00:00:00.000,경상북도,1962,1143,1025,937,47.76
2020-11-02 00:00:00.000,강원도,1799,1065,959,840,46.69
2020-11-02 00:00:00.000,경상남도,1648,903,823,825,50.06
2020-11-02 00:00:00.000,,1078,860,762,316,29.31
2020-11-02 00:00:00.000,충청북도,1459,854,801,658,45.1
2020-11-02 00:00:00.000,전라남도,1416,791,725,691,48.8
2020-11-02 00:00:00.000,부산광역시,1324,730,698,626,47.28
2020-11-02 00:00:00.000,전라북도,1258,727,652,606,48.17
2020-11-02 00:00:00.000,대전광역시,1091,638,622,469,42.99
2020-11-02 00:00:00.000,경기,794,561,443,351,44.21
2020-11-02 00:00:00.000,대구광역시,953,525,519,434,45.54
2020-11-02 00:00:00.000,광주광역시,842,473,443,399,47.39
2020-11-02 00:00:00.000,제주특별자치도,665,358,337,328,49.32
2020-11-02 00:00:00.000,울산광역시,548,307,275,273,49.82
2020-11-02 00:00:00.000,세종특별자치시,379,217,193,186,49.08
2020-11-02 00:00:00.000,인천광역,138,101,79,59,42.75
2020-11-02 00:00:00.000,인천,107,70,54,53,49.53
2020-11-02 00:00:00.000,충남,98,61,45,53,54.08
2020-11-02 00:00:00.000,강원,79,53,36,43,54.43
2020-11-02 00:00:00.000,경북,81,52,40,41,50.62
2020-11-02 00:00:00.000,경남,69,46,34,35,50.72
2020-11-02 00:00:00.000,부산광역,58,35,28,30,51.72
2020-11-02 00:00:00.000,전북,38,31,19,19,50
2020-11-02 00:00:00.000,광주광역,35,24,19,16,45.71
2020-11-02 00:00:00.000,충북,32,23,18,14,43.75
2020-11-02 00:00:00.000,대전,39,22,16,23,58.97
2020-11-02 00:00:00.000,전남,38,21,13,25,65.79
2020-11-02 00:00:00.000,광주,29,21,15,14,48.28
2020-11-02 00:00:00.000,대전광역,32,21,16,16,50
2020-11-02 00:00:00.000,★★★★★★★★,23,16,8,15,65.22
2020-11-02 00:00:00.000,대구광역,24,16,10,14,58.33
2020-11-02 00:00:00.000,부산,27,15,14,13,48.15
2020-11-02 00:00:00.000,대구,23,15,13,10,43.48
2020-11-02 00:00:00.000,울산,20,14,15,5,25
2020-11-02 00:00:00.000,울,13,11,8,5,38.46
2020-11-02 00:00:00.000,제주도,12,8,5,7,58.33
2020-11-02 00:00:00.000,서울강북구,9,8,9,0,0
2020-11-02 00:00:00.000,제주,12,7,6,6,50
2020-11-02 00:00:00.000,울산광역,7,6,6,1,14.29
2020-11-02 00:00:00.000,기,5,5,3,2,40
2020-11-02 00:00:00.000,강북구,4,3,1,3,75
2020-11-02 00:00:00.000,서울시,2,2,1,1,50
2020-11-02 00:00:00.000,천,1,1,1,0,0
2020-11-02 00:00:00.000,서대문구,1,1,1,0,0
2020-11-02 00:00:00.000,경남마산시해운동,3,1,2,1,33.33
2020-11-02 00:00:00.000,원,3,1,2,1,33.33
2020-11-02 00:00:00.000,산,2,1,2,0,0
2020-11-02 00:00:00.000,(주소불명)1119,2,1,1,1,50
2020-11-02 00:00:00.000,인천시,1,1,1,0,0
2020-11-09 00:00:00.000,서울특별시,49391,31188,27212,22179,44.9
2020-11-09 00:00:00.000,경기도,18385,11397,10098,8287,45.07
2020-11-09 00:00:00.000,인천광역시,3105,1854,1646,1459,46.99
2020-11-09 00:00:00.000,서울,2369,1682,1309,1060,44.74
2020-11-09 00:00:00.000,충청남도,2170,1365,1220,950,43.78
2020-11-09 00:00:00.000,경상북도,1969,1150,1024,945,47.99
2020-11-09 00:00:00.000,강원도,1688,1026,933,755,44.73
2020-11-09 00:00:00.000,경상남도,1620,875,826,794,49.01
2020-11-09 00:00:00.000,,1083,830,712,371,34.26
2020-11-09 00:00:00.000,충청북도,1338,813,712,626,46.79
2020-11-09 00:00:00.000,전라북도,1243,731,676,567,45.62
2020-11-09 00:00:00.000,부산광역시,1340,716,696,644,48.06
2020-11-09 00:00:00.000,전라남도,1237,714,668,569,46
2020-11-09 00:00:00.000,대전광역시,1064,606,542,522,49.06
2020-11-09 00:00:00.000,경기,759,543,425,334,44.01
2020-11-09 00:00:00.000,광주광역시,803,469,413,390,48.57
2020-11-09 00:00:00.000,대구광역시,825,459,413,412,49.94
2020-11-09 00:00:00.000,제주특별자치도,669,379,370,299,44.69
2020-11-09 00:00:00.000,울산광역시,423,246,223,200,47.28
2020-11-09 00:00:00.000,세종특별자치시,352,203,185,167,47.44
2020-11-09 00:00:00.000,인천광역,118,92,62,56,47.46
2020-11-09 00:00:00.000,충남,76,57,43,33,43.42
2020-11-09 00:00:00.000,인천,82,57,44,38,46.34
2020-11-09 00:00:00.000,강원,78,47,36,42,53.85
2020-11-09 00:00:00.000,경북,78,45,40,38,48.72
2020-11-09 00:00:00.000,경남,67,41,34,33,49.25
2020-11-09 00:00:00.000,충북,53,37,31,22,41.51
2020-11-09 00:00:00.000,전북,50,34,23,27,54
2020-11-09 00:00:00.000,대구광역,35,26,17,18,51.43
2020-11-09 00:00:00.000,부산,35,24,16,19,54.29
2020-11-09 00:00:00.000,부산광역,39,24,20,19,48.72
2020-11-09 00:00:00.000,전남,34,23,19,15,44.12
2020-11-09 00:00:00.000,대전광역,44,23,19,25,56.82
2020-11-09 00:00:00.000,★★★★★★★★,33,21,14,19,57.58
2020-11-09 00:00:00.000,광주,31,20,17,14,45.16
2020-11-09 00:00:00.000,대구,27,18,14,13,48.15
2020-11-09 00:00:00.000,광주광역,19,14,16,3,15.79
2020-11-09 00:00:00.000,대전,25,14,9,16,64
2020-11-09 00:00:00.000,제주도,17,12,10,7,41.18
2020-11-09 00:00:00.000,제주,18,11,9,9,50
2020-11-09 00:00:00.000,서울강북구,14,9,3,11,78.57
2020-11-09 00:00:00.000,울산광역,13,8,4,9,69.23
2020-11-09 00:00:00.000,울,8,7,6,2,25
2020-11-09 00:00:00.000,울산,10,5,2,8,80
2020-11-09 00:00:00.000,기,6,5,3,3,50
2020-11-09 00:00:00.000,서울시,3,3,2,1,33.33
2020-11-09 00:00:00.000,서울관악구봉천1동,1,1,1,0,0
2020-11-09 00:00:00.000,세종시,2,1,0,2,100
2020-11-09 00:00:00.000,남,4,1,0,4,100
2020-11-09 00:00:00.000,충부,2,1,0,2,100
2020-11-09 00:00:00.000,경기도양주군회천읍,1,1,1,0,0
2020-11-09 00:00:00.000,전,1,1,1,0,0
2020-11-09 00:00:00.000,원,1,1,1,0,0
2020-11-09 00:00:00.000,남동구만수2동,2,1,0,2,100
2020-11-09 00:00:00.000,(주소불명)1119,1,1,0,1,100
2020-11-16 00:00:00.000,서울특별시,48679,31077,27311,21368,43.9
2020-11-16 00:00:00.000,경기도,18399,11441,10119,8280,45
2020-11-16 00:00:00.000,인천광역시,3059,1879,1739,1320,43.15
2020-11-16 00:00:00.000,서울,2367,1694,1341,1026,43.35
2020-11-16 00:00:00.000,충청남도,2002,1228,1092,910,45.45
2020-11-16 00:00:00.000,경상북도,1921,1131,983,938,48.83
2020-11-16 00:00:00.000,강원도,1700,983,878,822,48.35
2020-11-16 00:00:00.000,경상남도,1532,860,803,729,47.58
2020-11-16 00:00:00.000,충청북도,1367,818,748,619,45.28
2020-11-16 00:00:00.000,,974,756,650,324,33.26
2020-11-16 00:00:00.000,전라북도,1278,729,639,639,50
2020-11-16 00:00:00.000,전라남도,1232,704,650,582,47.24
2020-11-16 00:00:00.000,부산광역시,1302,691,649,653,50.15
2020-11-16 00:00:00.000,대전광역시,1148,650,639,509,44.34
2020-11-16 00:00:00.000,경기,776,517,400,376,48.45
2020-11-16 00:00:00.000,대구광역시,889,512,456,433,48.71
2020-11-16 00:00:00.000,광주광역시,788,455,391,397,50.38
2020-11-16 00:00:00.000,제주특별자치도,725,377,384,341,47.03
2020-11-16 00:00:00.000,울산광역시,605,335,329,276,45.62
2020-11-16 00:00:00.000,세종특별자치시,371,218,191,180,48.52
2020-11-16 00:00:00.000,인천광역,128,88,69,59,46.09
2020-11-16 00:00:00.000,인천,89,63,44,45,50.56
2020-11-16 00:00:00.000,충남,87,60,44,43,49.43
2020-11-16 00:00:00.000,경북,79,56,40,39,49.37
2020-11-16 00:00:00.000,충북,68,47,34,34,50
2020-11-16 00:00:00.000,강원,66,43,31,35,53.03
2020-11-16 00:00:00.000,경남,47,34,25,22,46.81
2020-11-16 00:00:00.000,부산광역,39,29,24,15,38.46
2020-11-16 00:00:00.000,전남,56,27,21,35,62.5
2020-11-16 00:00:00.000,전북,53,27,24,29,54.72
2020-11-16 00:00:00.000,대전,37,23,20,17,45.95
2020-11-16 00:00:00.000,광주,33,23,23,10,30.3
2020-11-16 00:00:00.000,부산,38,21,12,26,68.42
2020-11-16 00:00:00.000,대전광역,28,18,11,17,60.71
2020-11-16 00:00:00.000,★★★★★★★★,30,18,9,21,70
2020-11-16 00:00:00.000,대구광역,25,15,11,14,56
2020-11-16 00:00:00.000,제주도,22,12,12,10,45.45
2020-11-16 00:00:00.000,광주광역,14,12,11,3,21.43
2020-11-16 00:00:00.000,대구,16,11,6,10,62.5
2020-11-16 00:00:00.000,울산,22,11,13,9,40.91
2020-11-16 00:00:00.000,울산광역,17,10,6,11,64.71
2020-11-16 00:00:00.000,제주,11,10,7,4,36.36
2020-11-16 00:00:00.000,서울강북구,14,10,10,4,28.57
2020-11-16 00:00:00.000,울,8,5,3,5,62.5
2020-11-16 00:00:00.000,기,5,4,3,2,40
2020-11-16 00:00:00.000,남,4,2,2,2,50
2020-11-16 00:00:00.000,서울시,3,2,1,2,66.67
2020-11-16 00:00:00.000,인천직할시,2,1,1,1,50
2020-11-16 00:00:00.000,충부,2,1,2,0,0
2020-11-16 00:00:00.000,주,1,1,1,0,0
2020-11-16 00:00:00.000,산,2,1,2,0,0
2020-11-16 00:00:00.000,남동구만수2동,2,1,0,2,100
2020-11-16 00:00:00.000,강북구,1,1,1,0,0
2020-11-16 00:00:00.000,전남여수시여서동,2,1,1,1,50
2020-11-16 00:00:00.000,부산시,1,1,1,0,0
2020-11-23 00:00:00.000,서울특별시,49042,31063,27464,21578,44
2020-11-23 00:00:00.000,경기도,18402,11468,10179,8223,44.69
2020-11-23 00:00:00.000,인천광역시,3145,1870,1695,1450,46.1
2020-11-23 00:00:00.000,서울,2271,1604,1270,1001,44.08
2020-11-23 00:00:00.000,충청남도,2169,1305,1185,984,45.37
2020-11-23 00:00:00.000,경상북도,2007,1156,1051,956,47.63
2020-11-23 00:00:00.000,강원도,1756,1050,964,792,45.1
2020-11-23 00:00:00.000,경상남도,1525,880,768,757,49.64
2020-11-23 00:00:00.000,충청북도,1379,804,760,619,44.89
2020-11-23 00:00:00.000,,950,774,691,259,27.26
2020-11-23 00:00:00.000,전라북도,1317,736,704,613,46.55
2020-11-23 00:00:00.000,전라남도,1296,730,650,646,49.85
2020-11-23 00:00:00.000,부산광역시,1254,661,630,624,49.76
2020-11-23 00:00:00.000,대전광역시,1179,643,646,533,45.21
2020-11-23 00:00:00.000,대구광역시,951,534,511,440,46.27
2020-11-23 00:00:00.000,경기,744,508,415,329,44.22
2020-11-23 00:00:00.000,광주광역시,846,460,450,396,46.81
2020-11-23 00:00:00.000,제주특별자치도,596,328,325,271,45.47
2020-11-23 00:00:00.000,울산광역시,475,268,259,216,45.47
2020-11-23 00:00:00.000,세종특별자치시,348,203,195,153,43.97
2020-11-23 00:00:00.000,인천광역,122,91,72,50,40.98
2020-11-23 00:00:00.000,인천,105,72,70,35,33.33
2020-11-23 00:00:00.000,충남,98,64,44,54,55.1
2020-11-23 00:00:00.000,강원,66,50,39,27,40.91
2020-11-23 00:00:00.000,경북,69,45,36,33,47.83
2020-11-23 00:00:00.000,전북,56,36,41,15,26.79
2020-11-23 00:00:00.000,충북,47,34,19,28,59.57
2020-11-23 00:00:00.000,대전광역,38,29,19,19,50
2020-11-23 00:00:00.000,전남,47,29,31,16,34.04
2020-11-23 00:00:00.000,경남,43,24,16,27,62.79
2020-11-23 00:00:00.000,부산광역,32,21,15,17,53.13
2020-11-23 00:00:00.000,광주광역,25,20,19,6,24
2020-11-23 00:00:00.000,대구광역,32,20,14,18,56.25
2020-11-23 00:00:00.000,대전,26,20,13,13,50
2020-11-23 00:00:00.000,부산,28,19,16,12,42.86
2020-11-23 00:00:00.000,광주,24,18,13,11,45.83
2020-11-23 00:00:00.000,★★★★★★★★,18,14,6,12,66.67
2020-11-23 00:00:00.000,제주도,21,11,9,12,57.14
2020-11-23 00:00:00.000,울산광역,16,11,13,3,18.75
2020-11-23 00:00:00.000,울산,21,10,6,15,71.43
2020-11-23 00:00:00.000,서울강북구,12,10,9,3,25
2020-11-23 00:00:00.000,대구,10,9,7,3,30
2020-11-23 00:00:00.000,울,9,7,4,5,55.56
2020-11-23 00:00:00.000,기,6,6,5,1,16.67
2020-11-23 00:00:00.000,제주,6,6,5,1,16.67
2020-11-23 00:00:00.000,남동구만수2동,2,2,2,0,0
2020-11-23 00:00:00.000,서대문구,1,1,0,1,100
2020-11-23 00:00:00.000,서울시,1,1,0,1,100
2020-11-23 00:00:00.000,서울관악구봉천1동,1,1,1,0,0
2020-11-23 00:00:00.000,인천직할시,1,1,1,0,0
2020-11-23 00:00:00.000,산,2,1,0,2,100
2020-11-30 00:00:00.000,서울특별시,49124,31174,27593,21531,43.83
2020-11-30 00:00:00.000,경기도,17915,11201,10028,7887,44.02
2020-11-30 00:00:00.000,인천광역시,3068,1827,1672,1396,45.5
2020-11-30 00:00:00.000,서울,2316,1684,1357,959,41.41
2020-11-30 00:00:00.000,충청남도,2087,1276,1169,918,43.99
2020-11-30 00:00:00.000,경상북도,1858,1050,987,871,46.88
2020-11-30 00:00:00.000,강원도,1724,983,943,781,45.3
2020-11-30 00:00:00.000,,1176,876,778,398,33.84
2020-11-30 00:00:00.000,경상남도,1531,820,777,754,49.25
2020-11-30 00:00:00.000,충청북도,1296,760,687,609,46.99
2020-11-30 00:00:00.000,전라남도,1198,689,605,593,49.5
2020-11-30 00:00:00.000,전라북도,1189,657,607,582,48.95
2020-11-30 00:00:00.000,대전광역시,1054,604,548,506,48.01
2020-11-30 00:00:00.000,부산광역시,1131,598,530,601,53.14
2020-11-30 00:00:00.000,경기,762,527,416,346,45.41
2020-11-30 00:00:00.000,대구광역시,837,489,478,359,42.89
2020-11-30 00:00:00.000,광주광역시,801,407,404,397,49.56
2020-11-30 00:00:00.000,제주특별자치도,603,311,314,289,47.93
2020-11-30 00:00:00.000,울산광역시,437,254,233,204,46.68
2020-11-30 00:00:00.000,세종특별자치시,365,220,180,185,50.68
2020-11-30 00:00:00.000,인천광역,107,78,65,42,39.25
2020-11-30 00:00:00.000,인천,83,65,60,23,27.71
2020-11-30 00:00:00.000,충남,67,51,41,26,38.81
2020-11-30 00:00:00.000,경북,83,48,41,42,50.6
2020-11-30 00:00:00.000,충북,51,35,30,21,41.18
2020-11-30 00:00:00.000,경남,59,34,32,27,45.76
2020-11-30 00:00:00.000,강원,50,32,24,26,52
2020-11-30 00:00:00.000,광주광역,38,25,24,14,36.84
2020-11-30 00:00:00.000,부산광역,34,22,14,20,58.82
2020-11-30 00:00:00.000,부산,38,21,22,16,42.11
2020-11-30 00:00:00.000,전북,34,20,21,13,38.24
2020-11-30 00:00:00.000,대전,30,20,14,16,53.33
2020-11-30 00:00:00.000,★★★★★★★★,28,18,10,18,64.29
2020-11-30 00:00:00.000,전남,30,18,18,12,40
2020-11-30 00:00:00.000,대전광역,24,17,14,10,41.67
2020-11-30 00:00:00.000,울산,29,14,14,15,51.72
2020-11-30 00:00:00.000,광주,19,14,11,8,42.11
2020-11-30 00:00:00.000,울,8,8,8,0,0
2020-11-30 00:00:00.000,대구,12,8,6,6,50
2020-11-30 00:00:00.000,대구광역,9,8,6,3,33.33
2020-11-30 00:00:00.000,제주,12,7,8,4,33.33
2020-11-30 00:00:00.000,울산광역,10,7,5,5,50
2020-11-30 00:00:00.000,서울강북구,10,7,5,5,50
2020-11-30 00:00:00.000,제주도,13,6,4,9,69.23
2020-11-30 00:00:00.000,남,6,4,4,2,33.33
2020-11-30 00:00:00.000,기,3,2,1,2,66.67
2020-11-30 00:00:00.000,서구,2,1,1,1,50
2020-11-30 00:00:00.000,세종시,1,1,1,0,0
2020-11-30 00:00:00.000,서울시,1,1,0,1,100
2020-11-30 00:00:00.000,경기도화성시송산동,2,1,1,1,50
2020-12-07 00:00:00.000,서울특별시,50055,31573,27983,22072,44.1
2020-12-07 00:00:00.000,경기도,18456,11538,10197,8259,44.75
2020-12-07 00:00:00.000,인천광역시,3157,1870,1781,1376,43.59
2020-12-07 00:00:00.000,서울,2521,1779,1449,1072,42.52
2020-12-07 00:00:00.000,충청남도,2143,1283,1164,979,45.68
2020-12-07 00:00:00.000,경상북도,1976,1104,976,1000,50.61
2020-12-07 00:00:00.000,강원도,1774,1030,946,828,46.67
2020-12-07 00:00:00.000,경상남도,1508,835,749,759,50.33
2020-12-07 00:00:00.000,충청북도,1299,753,739,560,43.11
2020-12-07 00:00:00.000,,992,751,626,366,36.9
2020-12-07 00:00:00.000,전라남도,1200,698,617,583,48.58
2020-12-07 00:00:00.000,부산광역시,1197,650,631,566,47.28
2020-12-07 00:00:00.000,전라북도,1109,644,568,541,48.78
2020-12-07 00:00:00.000,대전광역시,1142,633,618,524,45.88
2020-12-07 00:00:00.000,경기,803,566,430,373,46.45
2020-12-07 00:00:00.000,대구광역시,818,459,402,416,50.86
2020-12-07 00:00:00.000,광주광역시,804,433,408,396,49.25
2020-12-07 00:00:00.000,제주특별자치도,598,342,323,275,45.99
2020-12-07 00:00:00.000,울산광역시,436,268,232,204,46.79
2020-12-07 00:00:00.000,세종특별자치시,367,222,198,169,46.05
2020-12-07 00:00:00.000,인천광역,117,84,56,61,52.14
2020-12-07 00:00:00.000,충남,83,56,44,39,46.99
2020-12-07 00:00:00.000,인천,72,54,44,28,38.89
2020-12-07 00:00:00.000,경북,81,51,38,43,53.09
2020-12-07 00:00:00.000,경남,59,39,27,32,54.24
2020-12-07 00:00:00.000,충북,64,37,28,36,56.25
2020-12-07 00:00:00.000,강원,42,35,21,21,50
2020-12-07 00:00:00.000,전북,44,28,20,24,54.55
2020-12-07 00:00:00.000,부산광역,36,26,19,17,47.22
2020-12-07 00:00:00.000,광주광역,41,25,18,23,56.1
2020-12-07 00:00:00.000,★★★★★★★★,33,25,17,16,48.48
2020-12-07 00:00:00.000,대전,29,23,12,17,58.62
2020-12-07 00:00:00.000,전남,32,21,20,12,37.5
2020-12-07 00:00:00.000,대전광역,30,21,18,12,40
2020-12-07 00:00:00.000,부산,22,15,12,10,45.45
2020-12-07 00:00:00.000,광주,22,14,12,10,45.45
2020-12-07 00:00:00.000,대구,18,13,10,8,44.44
2020-12-07 00:00:00.000,대구광역,14,11,6,8,57.14
2020-12-07 00:00:00.000,울,13,10,7,6,46.15
2020-12-07 00:00:00.000,울산,17,9,5,12,70.59
2020-12-07 00:00:00.000,제주도,10,8,7,3,30
2020-12-07 00:00:00.000,서울강북구,7,6,6,1,14.29
2020-12-07 00:00:00.000,제주,7,4,6,1,14.29
2020-12-07 00:00:00.000,기,5,4,1,4,80
2020-12-07 00:00:00.000,서울시,4,3,1,3,75
2020-12-07 00:00:00.000,울산광역,4,3,1,3,75
2020-12-07 00:00:00.000,광주시,2,1,0,2,100
2020-12-07 00:00:00.000,북,2,1,0,2,100
2020-12-07 00:00:00.000,서울관악구봉천1동,1,1,1,0,0
2020-12-07 00:00:00.000,경기도화성시송산동,1,1,1,0,0
2020-12-07 00:00:00.000,대정광역,1,1,1,0,0
2020-12-07 00:00:00.000,서초구,1,1,1,0,0
2020-12-14 00:00:00.000,서울특별시,50533,30990,28697,21836,43.21
2020-12-14 00:00:00.000,경기도,18540,11401,10091,8449,45.57
2020-12-14 00:00:00.000,인천광역시,3041,1854,1694,1347,44.29
2020-12-14 00:00:00.000,서울,2233,1617,1282,951,42.59
2020-12-14 00:00:00.000,충청남도,2202,1327,1199,1003,45.55
2020-12-14 00:00:00.000,경상북도,1892,1070,933,959,50.69
2020-12-14 00:00:00.000,강원도,1747,1003,902,845,48.37
2020-12-14 00:00:00.000,경상남도,1582,818,772,810,51.2
2020-12-14 00:00:00.000,충청북도,1411,789,786,625,44.29
2020-12-14 00:00:00.000,,950,737,649,301,31.68
2020-12-14 00:00:00.000,전라남도,1310,702,661,649,49.54
2020-12-14 00:00:00.000,전라북도,1222,673,616,606,49.59
2020-12-14 00:00:00.000,대전광역시,1154,641,575,579,50.17
2020-12-14 00:00:00.000,부산광역시,1194,623,619,575,48.16
2020-12-14 00:00:00.000,경기,739,519,396,343,46.41
2020-12-14 00:00:00.000,대구광역시,866,476,428,438,50.58
2020-12-14 00:00:00.000,광주광역시,812,458,415,397,48.89
2020-12-14 00:00:00.000,제주특별자치도,624,324,326,298,47.76
2020-12-14 00:00:00.000,울산광역시,379,204,213,166,43.8
2020-12-14 00:00:00.000,세종특별자치시,339,192,159,180,53.1
2020-12-14 00:00:00.000,인천광역,95,69,59,36,37.89
2020-12-14 00:00:00.000,인천,105,66,52,53,50.48
2020-12-14 00:00:00.000,충남,80,56,43,37,46.25
2020-12-14 00:00:00.000,경북,68,44,32,36,52.94
2020-12-14 00:00:00.000,충북,57,38,28,29,50.88
2020-12-14 00:00:00.000,경남,56,32,20,36,64.29
2020-12-14 00:00:00.000,강원,62,32,22,40,64.52
2020-12-14 00:00:00.000,대전광역,34,24,19,15,44.12
2020-12-14 00:00:00.000,부산광역,33,23,15,18,54.55
2020-12-14 00:00:00.000,광주광역,31,22,19,12,38.71
2020-12-14 00:00:00.000,전북,33,22,17,16,48.48
2020-12-14 00:00:00.000,대전,24,17,8,16,66.67
2020-12-14 00:00:00.000,부산,32,17,13,19,59.38
2020-12-14 00:00:00.000,★★★★★★★★,20,16,5,15,75
2020-12-14 00:00:00.000,광주,26,15,10,16,61.54
2020-12-14 00:00:00.000,대구광역,23,15,11,12,52.17
2020-12-14 00:00:00.000,전남,29,13,17,12,41.38
2020-12-14 00:00:00.000,울산,9,9,6,3,33.33
2020-12-14 00:00:00.000,울,14,9,6,8,57.14
2020-12-14 00:00:00.000,울산광역,10,7,1,9,90
2020-12-14 00:00:00.000,대구,14,7,5,9,64.29
2020-12-14 00:00:00.000,서울강북구,10,7,5,5,50
2020-12-14 00:00:00.000,제주도,9,6,2,7,77.78
2020-12-14 00:00:00.000,제주,10,4,1,9,90
2020-12-14 00:00:00.000,남,6,3,4,2,33.33
2020-12-14 00:00:00.000,기,2,2,2,0,0
2020-12-14 00:00:00.000,서울시,2,2,1,1,50
2020-12-14 00:00:00.000,산,4,2,4,0,0
2020-12-14 00:00:00.000,경기의왕시포일동,1,1,1,0,0
2020-12-14 00:00:00.000,대동@,2,1,1,1,50
2020-12-14 00:00:00.000,광주시,1,1,1,0,0
2020-12-14 00:00:00.000,전,2,1,0,2,100
2020-12-14 00:00:00.000,강서구,1,1,1,0,0
2020-12-14 00:00:00.000,원주시,1,1,0,1,100
2020-12-14 00:00:00.000,경기도화성시송산동,1,1,1,0,0
2020-12-21 00:00:00.000,서울특별시,41923,26527,24051,17872,42.63
2020-12-21 00:00:00.000,경기도,15006,9476,8450,6556,43.69
2020-12-21 00:00:00.000,인천광역시,2508,1494,1379,1129,45.02
2020-12-21 00:00:00.000,서울,1856,1340,1107,749,40.36
2020-12-21 00:00:00.000,충청남도,1712,1058,935,777,45.39
2020-12-21 00:00:00.000,경상북도,1616,903,868,748,46.29
2020-12-21 00:00:00.000,강원도,1366,802,737,629,46.05
2020-12-21 00:00:00.000,경상남도,1213,685,614,599,49.38
2020-12-21 00:00:00.000,충청북도,1113,657,629,484,43.49
2020-12-21 00:00:00.000,,834,647,526,308,36.93
2020-12-21 00:00:00.000,전라남도,1018,598,516,502,49.31
2020-12-21 00:00:00.000,부산광역시,974,538,483,491,50.41
2020-12-21 00:00:00.000,대전광역시,887,537,471,416,46.9
2020-12-21 00:00:00.000,전라북도,954,532,473,481,50.42
2020-12-21 00:00:00.000,경기,648,455,363,285,43.98
2020-12-21 00:00:00.000,대구광역시,657,374,340,317,48.25
2020-12-21 00:00:00.000,광주광역시,646,367,319,327,50.62
2020-12-21 00:00:00.000,제주특별자치도,511,254,243,268,52.45
2020-12-21 00:00:00.000,울산광역시,377,212,192,185,49.07
2020-12-21 00:00:00.000,세종특별자치시,270,167,150,120,44.44
2020-12-21 00:00:00.000,인천,68,56,45,23,33.82
2020-12-21 00:00:00.000,충남,85,55,49,36,42.35
2020-12-21 00:00:00.000,인천광역,82,55,37,45,54.88
2020-12-21 00:00:00.000,강원,46,33,25,21,45.65
2020-12-21 00:00:00.000,경북,45,31,23,22,48.89
2020-12-21 00:00:00.000,경남,45,31,25,20,44.44
2020-12-21 00:00:00.000,★★★★★★★★,30,25,14,16,53.33
2020-12-21 00:00:00.000,충북,27,21,17,10,37.04
2020-12-21 00:00:00.000,부산광역,29,18,15,14,48.28
2020-12-21 00:00:00.000,광주,29,18,15,14,48.28
2020-12-21 00:00:00.000,대전,22,16,7,15,68.18
2020-12-21 00:00:00.000,전남,29,15,12,17,58.62
2020-12-21 00:00:00.000,광주광역,17,15,11,6,35.29
2020-12-21 00:00:00.000,전북,21,15,10,11,52.38
2020-12-21 00:00:00.000,대구,18,14,10,8,44.44
2020-12-21 00:00:00.000,대전광역,19,13,10,9,47.37
2020-12-21 00:00:00.000,부산,19,13,8,11,57.89
2020-12-21 00:00:00.000,대구광역,14,10,7,7,50
2020-12-21 00:00:00.000,울산광역,11,8,7,4,36.36
2020-12-21 00:00:00.000,제주,12,7,6,6,50
2020-12-21 00:00:00.000,울산,10,7,2,8,80
2020-12-21 00:00:00.000,서울강북구,6,5,4,2,33.33
2020-12-21 00:00:00.000,울,7,5,4,3,42.86
2020-12-21 00:00:00.000,제주도,5,4,2,3,60
2020-12-21 00:00:00.000,서울시,4,2,2,2,50
2020-12-21 00:00:00.000,남,3,2,2,1,33.33
2020-12-21 00:00:00.000,기,2,2,2,0,0
2020-12-21 00:00:00.000,경기용인시풍덕천2동,1,1,1,0,0
2020-12-21 00:00:00.000,부산시,1,1,1,0,0
2020-12-21 00:00:00.000,산,2,1,1,1,50
2020-12-21 00:00:00.000,강북구,3,1,2,1,33.33
2020-12-21 00:00:00.000,전,1,1,1,0,0
2020-12-21 00:00:00.000,대동@,3,1,1,2,66.67
2020-12-28 00:00:00.000,서울특별시,38955,24447,21148,17807,45.71
2020-12-28 00:00:00.000,경기도,14205,8920,7552,6653,46.84
2020-12-28 00:00:00.000,인천광역시,2320,1410,1233,1087,46.85
2020-12-28 00:00:00.000,서울,1636,1162,895,741,45.29
2020-12-28 00:00:00.000,충청남도,1537,955,806,731,47.56
2020-12-28 00:00:00.000,경상북도,1387,796,680,707,50.97
2020-12-28 00:00:00.000,강원도,1289,765,638,651,50.5
2020-12-28 00:00:00.000,충청북도,1133,629,540,593,52.34
2020-12-28 00:00:00.000,,785,622,567,218,27.77
2020-12-28 00:00:00.000,경상남도,1062,613,505,557,52.45
2020-12-28 00:00:00.000,전라북도,853,510,438,415,48.65
2020-12-28 00:00:00.000,전라남도,892,510,402,490,54.93
2020-12-28 00:00:00.000,부산광역시,899,490,404,495,55.06
2020-12-28 00:00:00.000,대전광역시,729,439,381,348,47.74
2020-12-28 00:00:00.000,경기,550,382,292,258,46.91
2020-12-28 00:00:00.000,광주광역시,638,349,295,343,53.76
2020-12-28 00:00:00.000,대구광역시,583,332,265,318,54.55
2020-12-28 00:00:00.000,제주특별자치도,453,239,197,256,56.51
2020-12-28 00:00:00.000,울산광역시,315,179,142,173,54.92
2020-12-28 00:00:00.000,세종특별자치시,258,154,128,130,50.39
2020-12-28 00:00:00.000,인천광역,72,52,44,28,38.89
2020-12-28 00:00:00.000,충남,54,38,20,34,62.96
2020-12-28 00:00:00.000,인천,50,37,26,24,48
2020-12-28 00:00:00.000,경남,47,27,19,28,59.57
2020-12-28 00:00:00.000,대전광역,29,23,15,14,48.28
2020-12-28 00:00:00.000,경북,29,20,13,16,55.17
2020-12-28 00:00:00.000,강원,28,18,10,18,64.29
2020-12-28 00:00:00.000,충북,24,17,8,16,66.67
2020-12-28 00:00:00.000,부산광역,23,16,12,11,47.83
2020-12-28 00:00:00.000,★★★★★★★★,18,16,7,11,61.11
2020-12-28 00:00:00.000,전북,31,16,11,20,64.52
2020-12-28 00:00:00.000,대전,22,14,10,12,54.55
2020-12-28 00:00:00.000,광주광역,23,14,9,14,60.87
2020-12-28 00:00:00.000,전남,30,12,15,15,50
2020-12-28 00:00:00.000,광주,19,12,9,10,52.63
2020-12-28 00:00:00.000,대구,19,11,5,14,73.68
2020-12-28 00:00:00.000,부산,12,10,6,6,50
2020-12-28 00:00:00.000,대구광역,16,10,9,7,43.75
2020-12-28 00:00:00.000,서울강북구,10,8,6,4,40
2020-12-28 00:00:00.000,울산,13,7,5,8,61.54
2020-12-28 00:00:00.000,울,7,7,6,1,14.29
2020-12-28 00:00:00.000,울산광역,9,7,4,5,55.56
2020-12-28 00:00:00.000,제주,14,6,5,9,64.29
2020-12-28 00:00:00.000,기,9,6,3,6,66.67
2020-12-28 00:00:00.000,제주도,5,5,2,3,60
2020-12-28 00:00:00.000,남,3,2,0,3,100
2020-12-28 00:00:00.000,서울시,3,2,1,2,66.67
2020-12-28 00:00:00.000,산,3,1,2,1,33.33
2020-12-28 00:00:00.000,강북구,1,1,1,0,0
2020-12-28 00:00:00.000,천,1,1,1,0,0
2020-12-28 00:00:00.000,북,1,1,1,0,0
2020-12-28 00:00:00.000,대동@,1,1,1,0,0
2021-01-04 00:00:00.000,서울특별시,50091,30973,27428,22663,45.24
2021-01-04 00:00:00.000,경기도,18029,11123,9745,8284,45.95
2021-01-04 00:00:00.000,인천광역시,2993,1780,1625,1368,45.71
2021-01-04 00:00:00.000,서울,2361,1648,1284,1077,45.62
2021-01-04 00:00:00.000,충청남도,2076,1236,1095,981,47.25
2021-01-04 00:00:00.000,강원도,1763,1051,905,858,48.67
2021-01-04 00:00:00.000,경상북도,1779,994,879,900,50.59
2021-01-04 00:00:00.000,경상남도,1572,842,775,797,50.7
2021-01-04 00:00:00.000,,1056,807,656,400,37.88
2021-01-04 00:00:00.000,충청북도,1397,784,741,656,46.96
2021-01-04 00:00:00.000,전라북도,1216,684,601,615,50.58
2021-01-04 00:00:00.000,전라남도,1190,669,591,599,50.34
2021-01-04 00:00:00.000,부산광역시,1246,646,629,617,49.52
2021-01-04 00:00:00.000,대전광역시,1109,612,534,575,51.85
2021-01-04 00:00:00.000,경기,828,563,411,417,50.36
2021-01-04 00:00:00.000,대구광역시,798,460,393,405,50.75
2021-01-04 00:00:00.000,광주광역시,859,440,415,444,51.69
2021-01-04 00:00:00.000,울산광역시,546,295,265,281,51.47
2021-01-04 00:00:00.000,제주특별자치도,568,285,242,326,57.39
2021-01-04 00:00:00.000,세종특별자치시,374,215,189,185,49.47
2021-01-04 00:00:00.000,인천광역,117,81,61,56,47.86
2021-01-04 00:00:00.000,인천,85,56,44,41,48.24
2021-01-04 00:00:00.000,충남,63,42,33,30,47.62
2021-01-04 00:00:00.000,강원,68,38,21,47,69.12
2021-01-04 00:00:00.000,경북,58,36,30,28,48.28
2021-01-04 00:00:00.000,전북,53,31,20,33,62.26
2021-01-04 00:00:00.000,광주광역,36,26,15,21,58.33
2021-01-04 00:00:00.000,충북,38,25,14,24,63.16
2021-01-04 00:00:00.000,경남,37,25,17,20,54.05
2021-01-04 00:00:00.000,부산광역,38,23,18,20,52.63
2021-01-04 00:00:00.000,대전광역,32,18,16,16,50
2021-01-04 00:00:00.000,광주,22,18,15,7,31.82
2021-01-04 00:00:00.000,대전,29,18,16,13,44.83
2021-01-04 00:00:00.000,전남,29,17,15,14,48.28
2021-01-04 00:00:00.000,부산,20,15,12,8,40
2021-01-04 00:00:00.000,대구,18,14,10,8,44.44
2021-01-04 00:00:00.000,대구광역,17,12,8,9,52.94
2021-01-04 00:00:00.000,울산광역,15,12,9,6,40
2021-01-04 00:00:00.000,제주도,19,12,5,14,73.68
2021-01-04 00:00:00.000,★★★★★★★★,15,11,10,5,33.33
2021-01-04 00:00:00.000,서울강북구,20,10,9,11,55
2021-01-04 00:00:00.000,울,9,9,6,3,33.33
2021-01-04 00:00:00.000,제주,17,9,5,12,70.59
2021-01-04 00:00:00.000,울산,12,7,7,5,41.67
2021-01-04 00:00:00.000,남,4,3,3,1,25
2021-01-04 00:00:00.000,기,3,3,3,0,0
2021-01-04 00:00:00.000,경기용인시풍덕천2동,2,1,1,1,50
2021-01-04 00:00:00.000,강북구,1,1,1,0,0
2021-01-04 00:00:00.000,원,1,1,0,1,100
2021-01-04 00:00:00.000,서울시,1,1,0,1,100
2021-01-11 00:00:00.000,서울특별시,49233,30801,27659,21574,43.82
2021-01-11 00:00:00.000,경기도,18147,11166,9904,8243,45.42
2021-01-11 00:00:00.000,인천광역시,3195,1853,1717,1478,46.26
2021-01-11 00:00:00.000,서울,2379,1636,1352,1027,43.17
2021-01-11 00:00:00.000,충청남도,2191,1304,1225,966,44.09
2021-01-11 00:00:00.000,경상북도,1887,1063,962,925,49.02
2021-01-11 00:00:00.000,강원도,1763,1016,935,828,46.97
2021-01-11 00:00:00.000,경상남도,1601,870,787,814,50.84
2021-01-11 00:00:00.000,충청북도,1399,811,760,639,45.68
2021-01-11 00:00:00.000,,1017,783,665,352,34.61
2021-01-11 00:00:00.000,전라북도,1289,714,641,648,50.27
2021-01-11 00:00:00.000,전라남도,1302,711,622,680,52.23
2021-01-11 00:00:00.000,부산광역시,1285,666,651,634,49.34
2021-01-11 00:00:00.000,대전광역시,1133,643,620,513,45.28
2021-01-11 00:00:00.000,경기,853,568,465,388,45.49
2021-01-11 00:00:00.000,광주광역시,825,490,435,390,47.27
2021-01-11 00:00:00.000,대구광역시,842,476,452,390,46.32
2021-01-11 00:00:00.000,제주특별자치도,738,378,392,346,46.88
2021-01-11 00:00:00.000,울산광역시,468,269,222,246,52.56
2021-01-11 00:00:00.000,세종특별자치시,360,215,197,163,45.28
2021-01-11 00:00:00.000,인천광역,144,94,79,65,45.14
2021-01-11 00:00:00.000,인천,101,74,60,41,40.59
2021-01-11 00:00:00.000,경북,82,49,36,46,56.1
2021-01-11 00:00:00.000,충남,77,48,42,35,45.45
2021-01-11 00:00:00.000,강원,74,48,47,27,36.49
2021-01-11 00:00:00.000,경남,63,40,31,32,50.79
2021-01-11 00:00:00.000,충북,49,33,24,25,51.02
2021-01-11 00:00:00.000,전북,47,31,25,22,46.81
2021-01-11 00:00:00.000,부산광역,37,25,16,21,56.76
2021-01-11 00:00:00.000,전남,40,24,17,23,57.5
2021-01-11 00:00:00.000,대전광역,32,24,20,12,37.5
2021-01-11 00:00:00.000,광주,34,21,15,19,55.88
2021-01-11 00:00:00.000,광주광역,25,20,18,7,28
2021-01-11 00:00:00.000,대전,30,20,11,19,63.33
2021-01-11 00:00:00.000,대구광역,19,14,11,8,42.11
2021-01-11 00:00:00.000,울산광역,16,11,8,8,50
2021-01-11 00:00:00.000,★★★★★★★★,16,11,8,8,50
2021-01-11 00:00:00.000,부산,17,10,5,12,70.59
2021-01-11 00:00:00.000,제주,19,9,6,13,68.42
2021-01-11 00:00:00.000,대구,13,9,7,6,46.15
2021-01-11 00:00:00.000,제주도,16,8,8,8,50
2021-01-11 00:00:00.000,울산,11,7,5,6,54.55
2021-01-11 00:00:00.000,서울강북구,9,6,3,6,66.67
2021-01-11 00:00:00.000,울,8,6,5,3,37.5
2021-01-11 00:00:00.000,기,4,3,2,2,50
2021-01-11 00:00:00.000,서울관악구봉천1동,3,3,2,1,33.33
2021-01-11 00:00:00.000,대동@,1,1,1,0,0
2021-01-11 00:00:00.000,북,2,1,1,1,50
2021-01-11 00:00:00.000,광진구,1,1,0,1,100
2021-01-11 00:00:00.000,남,1,1,1,0,0
2021-01-11 00:00:00.000,서울시,5,1,1,4,80
2021-01-11 00:00:00.000,강북구,1,1,1,0,0
2021-01-11 00:00:00.000,산,2,1,2,0,0
2021-01-18 00:00:00.000,서울특별시,50119,31291,28040,22079,44.05
2021-01-18 00:00:00.000,경기도,18585,11499,10345,8240,44.34
2021-01-18 00:00:00.000,인천광역시,3198,1841,1781,1417,44.31
2021-01-18 00:00:00.000,서울,2416,1716,1375,1041,43.09
2021-01-18 00:00:00.000,충청남도,2130,1297,1162,968,45.45
2021-01-18 00:00:00.000,경상북도,1881,1084,995,886,47.1
2021-01-18 00:00:00.000,강원도,1895,1080,978,917,48.39
2021-01-18 00:00:00.000,경상남도,1552,887,771,781,50.32
2021-01-18 00:00:00.000,충청북도,1399,810,756,643,45.96
2021-01-18 00:00:00.000,,1010,774,647,363,35.94
2021-01-18 00:00:00.000,전라북도,1305,750,704,601,46.05
2021-01-18 00:00:00.000,전라남도,1313,721,650,663,50.5
2021-01-18 00:00:00.000,부산광역시,1368,695,675,693,50.66
2021-01-18 00:00:00.000,대전광역시,1139,635,590,549,48.2
2021-01-18 00:00:00.000,경기,753,530,459,294,39.04
2021-01-18 00:00:00.000,대구광역시,891,479,447,444,49.83
2021-01-18 00:00:00.000,광주광역시,853,468,450,403,47.25
2021-01-18 00:00:00.000,제주특별자치도,678,345,345,333,49.12
2021-01-18 00:00:00.000,울산광역시,484,252,250,234,48.35
2021-01-18 00:00:00.000,세종특별자치시,350,214,202,148,42.29
2021-01-18 00:00:00.000,인천광역,146,104,84,62,42.47
2021-01-18 00:00:00.000,인천,88,67,56,32,36.36
2021-01-18 00:00:00.000,충남,82,58,48,34,41.46
2021-01-18 00:00:00.000,경북,69,43,27,42,60.87
2021-01-18 00:00:00.000,충북,54,40,29,25,46.3
2021-01-18 00:00:00.000,경남,63,39,27,36,57.14
2021-01-18 00:00:00.000,강원,48,34,21,27,56.25
2021-01-18 00:00:00.000,전북,39,28,17,22,56.41
2021-01-18 00:00:00.000,대전광역,35,27,20,15,42.86
2021-01-18 00:00:00.000,전남,36,26,22,14,38.89
2021-01-18 00:00:00.000,부산광역,37,25,17,20,54.05
2021-01-18 00:00:00.000,광주,39,24,23,16,41.03
2021-01-18 00:00:00.000,대전,25,20,16,9,36
2021-01-18 00:00:00.000,광주광역,35,20,19,16,45.71
2021-01-18 00:00:00.000,부산,27,15,15,12,44.44
2021-01-18 00:00:00.000,대구광역,18,13,7,11,61.11
2021-01-18 00:00:00.000,울산,20,11,5,15,75
2021-01-18 00:00:00.000,서울강북구,14,10,8,6,42.86
2021-01-18 00:00:00.000,★★★★★★★★,15,10,4,11,73.33
2021-01-18 00:00:00.000,제주도,15,9,4,11,73.33
2021-01-18 00:00:00.000,제주,11,8,6,5,45.45
2021-01-18 00:00:00.000,대구,12,8,7,5,41.67
2021-01-18 00:00:00.000,울산광역,9,7,7,2,22.22
2021-01-18 00:00:00.000,울,5,5,4,1,20
2021-01-18 00:00:00.000,기,6,3,0,6,100
2021-01-18 00:00:00.000,남,4,3,3,1,25
2021-01-18 00:00:00.000,서울관악구봉천1동,1,1,1,0,0
2021-01-18 00:00:00.000,경기도화성시송산동,1,1,1,0,0
2021-01-18 00:00:00.000,천,6,1,1,5,83.33
2021-01-18 00:00:00.000,강북구,1,1,0,1,100
2021-01-18 00:00:00.000,북,2,1,1,1,50
2021-01-18 00:00:00.000,산,3,1,2,1,33.33
2021-01-18 00:00:00.000,서울시,2,1,1,1,50
2021-01-25 00:00:00.000,서울특별시,48428,30340,27130,21298,43.98
2021-01-25 00:00:00.000,경기도,17987,11112,10001,7986,44.4
2021-01-25 00:00:00.000,인천광역시,3162,1854,1717,1445,45.7
2021-01-25 00:00:00.000,서울,2291,1636,1297,994,43.39
2021-01-25 00:00:00.000,충청남도,2171,1288,1176,995,45.83
2021-01-25 00:00:00.000,강원도,1793,1080,1003,790,44.06
2021-01-25 00:00:00.000,경상북도,1896,1045,974,922,48.63
2021-01-25 00:00:00.000,충청북도,1474,864,799,675,45.79
2021-01-25 00:00:00.000,경상남도,1611,849,770,841,52.2
2021-01-25 00:00:00.000,,945,723,627,318,33.65
2021-01-25 00:00:00.000,전라북도,1311,720,653,658,50.19
2021-01-25 00:00:00.000,전라남도,1288,720,659,629,48.84
2021-01-25 00:00:00.000,부산광역시,1225,667,633,592,48.33
2021-01-25 00:00:00.000,대전광역시,1129,655,566,563,49.87
2021-01-25 00:00:00.000,대구광역시,880,517,469,411,46.7
2021-01-25 00:00:00.000,경기,716,495,371,345,48.18
2021-01-25 00:00:00.000,광주광역시,837,447,431,406,48.51
2021-01-25 00:00:00.000,제주특별자치도,705,330,345,360,51.06
2021-01-25 00:00:00.000,울산광역시,501,271,249,252,50.3
2021-01-25 00:00:00.000,세종특별자치시,337,199,185,152,45.1
2021-01-25 00:00:00.000,인천광역,142,102,87,55,38.73
2021-01-25 00:00:00.000,인천,84,59,51,33,39.29
2021-01-25 00:00:00.000,충남,89,55,46,43,48.31
2021-01-25 00:00:00.000,경남,75,44,28,47,62.67
2021-01-25 00:00:00.000,충북,49,34,33,16,32.65
2021-01-25 00:00:00.000,경북,56,34,28,28,50
2021-01-25 00:00:00.000,강원,38,29,23,15,39.47
2021-01-25 00:00:00.000,부산광역,35,26,14,21,60
2021-01-25 00:00:00.000,전북,39,25,22,17,43.59
2021-01-25 00:00:00.000,광주광역,31,23,13,18,58.06
2021-01-25 00:00:00.000,대전광역,28,19,10,18,64.29
2021-01-25 00:00:00.000,대전,26,16,13,13,50
2021-01-25 00:00:00.000,전남,22,16,12,10,45.45
2021-01-25 00:00:00.000,광주,21,15,12,9,42.86
2021-01-25 00:00:00.000,부산,18,14,12,6,33.33
2021-01-25 00:00:00.000,★★★★★★★★,14,12,8,6,42.86
2021-01-25 00:00:00.000,대구광역,21,12,10,11,52.38
2021-01-25 00:00:00.000,울산,15,10,5,10,66.67
2021-01-25 00:00:00.000,대구,12,9,7,5,41.67
2021-01-25 00:00:00.000,제주도,11,7,5,6,54.55
2021-01-25 00:00:00.000,기,9,7,4,5,55.56
2021-01-25 00:00:00.000,서울강북구,8,7,6,2,25
2021-01-25 00:00:00.000,울산광역,8,6,5,3,37.5
2021-01-25 00:00:00.000,울,9,5,7,2,22.22
2021-01-25 00:00:00.000,서울시,3,3,2,1,33.33
2021-01-25 00:00:00.000,제주,3,2,0,3,100
2021-01-25 00:00:00.000,인천시,1,1,0,1,100
2021-01-25 00:00:00.000,강북구,1,1,0,1,100
2021-01-25 00:00:00.000,북,1,1,1,0,0
2021-01-25 00:00:00.000,주,2,1,0,2,100
2021-02-01 00:00:00.000,서울특별시,49461,31127,27797,21664,43.8
2021-02-01 00:00:00.000,경기도,18586,11551,10499,8087,43.51
2021-02-01 00:00:00.000,인천광역시,3100,1849,1750,1350,43.55
2021-02-01 00:00:00.000,서울,2300,1610,1351,949,41.26
2021-02-01 00:00:00.000,충청남도,2210,1308,1212,998,45.16
2021-02-01 00:00:00.000,경상북도,1897,1071,977,920,48.5
2021-02-01 00:00:00.000,강원도,1785,1040,960,825,46.22
2021-02-01 00:00:00.000,경상남도,1592,873,795,797,50.06
2021-02-01 00:00:00.000,충청북도,1351,830,749,602,44.56
2021-02-01 00:00:00.000,전라북도,1356,751,702,654,48.23
2021-02-01 00:00:00.000,,945,727,645,300,31.75
2021-02-01 00:00:00.000,전라남도,1371,719,708,663,48.36
2021-02-01 00:00:00.000,부산광역시,1289,664,685,604,46.86
2021-02-01 00:00:00.000,대전광역시,1142,652,621,521,45.62
2021-02-01 00:00:00.000,경기,808,554,458,350,43.32
2021-02-01 00:00:00.000,대구광역시,835,477,471,364,43.59
2021-02-01 00:00:00.000,광주광역시,799,442,443,356,44.56
2021-02-01 00:00:00.000,제주특별자치도,704,383,384,320,45.45
2021-02-01 00:00:00.000,울산광역시,535,274,284,251,46.92
2021-02-01 00:00:00.000,세종특별자치시,325,202,188,137,42.15
2021-02-01 00:00:00.000,인천,137,85,72,65,47.45
2021-02-01 00:00:00.000,인천광역,108,82,69,39,36.11
2021-02-01 00:00:00.000,충남,81,58,49,32,39.51
2021-02-01 00:00:00.000,경북,53,38,32,21,39.62
2021-02-01 00:00:00.000,경남,51,31,29,22,43.14
2021-02-01 00:00:00.000,강원,42,30,24,18,42.86
2021-02-01 00:00:00.000,충북,40,29,22,18,45
2021-02-01 00:00:00.000,대전광역,33,28,22,11,33.33
2021-02-01 00:00:00.000,광주광역,35,25,18,17,48.57
2021-02-01 00:00:00.000,광주,36,22,20,16,44.44
2021-02-01 00:00:00.000,전북,28,21,19,9,32.14
2021-02-01 00:00:00.000,부산광역,23,19,12,11,47.83
2021-02-01 00:00:00.000,전남,31,17,15,16,51.61
2021-02-01 00:00:00.000,부산,22,16,11,11,50
2021-02-01 00:00:00.000,★★★★★★★★,20,15,8,12,60
2021-02-01 00:00:00.000,울산,18,13,12,6,33.33
2021-02-01 00:00:00.000,울산광역,15,11,8,7,46.67
2021-02-01 00:00:00.000,서울강북구,12,11,7,5,41.67
2021-02-01 00:00:00.000,대구광역,15,10,9,6,40
2021-02-01 00:00:00.000,대전,11,10,8,3,27.27
2021-02-01 00:00:00.000,제주도,16,9,5,11,68.75
2021-02-01 00:00:00.000,울,10,8,6,4,40
2021-02-01 00:00:00.000,제주,10,6,4,6,60
2021-02-01 00:00:00.000,대구,7,6,3,4,57.14
2021-02-01 00:00:00.000,기,7,5,6,1,14.29
2021-02-01 00:00:00.000,경기도화성시송산동,3,2,1,2,66.67
2021-02-01 00:00:00.000,서울시,1,1,0,1,100
2021-02-01 00:00:00.000,광주시,1,1,1,0,0
2021-02-01 00:00:00.000,주,1,1,1,0,0
2021-02-01 00:00:00.000,경기용인시풍덕천2동,1,1,1,0,0
2021-02-01 00:00:00.000,울주군,1,1,1,0,0
2021-02-01 00:00:00.000,인천시,1,1,1,0,0
2021-02-01 00:00:00.000,남,2,1,0,2,100
2021-02-01 00:00:00.000,강북구,1,1,1,0,0
2021-02-01 00:00:00.000,원,2,1,1,1,50
2021-02-08 00:00:00.000,서울특별시,32173,21430,18197,13976,43.44
2021-02-08 00:00:00.000,경기도,11858,7673,6723,5135,43.3
2021-02-08 00:00:00.000,인천광역시,2170,1287,1146,1024,47.19
2021-02-08 00:00:00.000,서울,1328,1015,789,539,40.59
2021-02-08 00:00:00.000,충청남도,1280,811,717,563,43.98
2021-02-08 00:00:00.000,강원도,1032,652,602,430,41.67
2021-02-08 00:00:00.000,경상북도,980,587,492,488,49.8
2021-02-08 00:00:00.000,,690,576,487,203,29.42
2021-02-08 00:00:00.000,충청북도,841,526,475,366,43.52
2021-02-08 00:00:00.000,경상남도,900,504,429,471,52.33
2021-02-08 00:00:00.000,전라북도,754,454,401,353,46.82
2021-02-08 00:00:00.000,전라남도,709,415,346,363,51.2
2021-02-08 00:00:00.000,부산광역시,697,388,367,330,47.35
2021-02-08 00:00:00.000,대전광역시,634,363,318,316,49.84
2021-02-08 00:00:00.000,경기,432,318,245,187,43.29
2021-02-08 00:00:00.000,대구광역시,478,302,228,250,52.3
2021-02-08 00:00:00.000,광주광역시,472,265,222,250,52.97
2021-02-08 00:00:00.000,제주특별자치도,402,231,222,180,44.78
2021-02-08 00:00:00.000,울산광역시,306,176,163,143,46.73
2021-02-08 00:00:00.000,세종특별자치시,193,120,111,82,42.49
2021-02-08 00:00:00.000,인천광역,86,62,51,35,40.7
2021-02-08 00:00:00.000,인천,65,49,39,26,40
2021-02-08 00:00:00.000,경북,37,27,19,18,48.65
2021-02-08 00:00:00.000,강원,35,27,18,17,48.57
2021-02-08 00:00:00.000,충남,29,24,16,13,44.83
2021-02-08 00:00:00.000,전북,25,17,12,13,52
2021-02-08 00:00:00.000,충북,18,16,14,4,22.22
2021-02-08 00:00:00.000,대전광역,23,15,11,12,52.17
2021-02-08 00:00:00.000,경남,24,15,10,14,58.33
2021-02-08 00:00:00.000,전남,14,12,11,3,21.43
2021-02-08 00:00:00.000,대구,22,12,7,15,68.18
2021-02-08 00:00:00.000,부산광역,21,12,8,13,61.9
2021-02-08 00:00:00.000,부산,13,9,7,6,46.15
2021-02-08 00:00:00.000,광주광역,11,9,7,4,36.36
2021-02-08 00:00:00.000,★★★★★★★★,12,9,6,6,50
2021-02-08 00:00:00.000,울,11,8,6,5,45.45
2021-02-08 00:00:00.000,대전,14,8,4,10,71.43
2021-02-08 00:00:00.000,서울강북구,8,7,5,3,37.5
2021-02-08 00:00:00.000,광주,7,6,3,4,57.14
2021-02-08 00:00:00.000,제주도,7,6,4,3,42.86
2021-02-08 00:00:00.000,울산,8,5,4,4,50
2021-02-08 00:00:00.000,대구광역,5,4,1,4,80
2021-02-08 00:00:00.000,울산광역,3,3,1,2,66.67
2021-02-08 00:00:00.000,남,3,2,1,2,66.67
2021-02-08 00:00:00.000,기,6,2,0,6,100
2021-02-08 00:00:00.000,천,4,1,1,3,75
2021-02-08 00:00:00.000,산,2,1,2,0,0
2021-02-08 00:00:00.000,제주,1,1,1,0,0
2021-02-08 00:00:00.000,서울시,3,1,0,3,100
2021-02-15 00:00:00.000,서울특별시,52024,32336,28898,23126,44.45
2021-02-15 00:00:00.000,경기도,19737,12067,10903,8834,44.76
2021-02-15 00:00:00.000,인천광역시,3467,2055,1892,1575,45.43
2021-02-15 00:00:00.000,서울,2327,1656,1316,1011,43.45
2021-02-15 00:00:00.000,충청남도,2355,1456,1326,1029,43.69
2021-02-15 00:00:00.000,경상북도,2161,1213,1170,991,45.86
2021-02-15 00:00:00.000,강원도,1969,1115,1074,895,45.45
2021-02-15 00:00:00.000,경상남도,1909,1031,957,952,49.87
2021-02-15 00:00:00.000,충청북도,1553,897,848,705,45.4
2021-02-15 00:00:00.000,전라남도,1477,844,745,732,49.56
2021-02-15 00:00:00.000,,1038,801,693,345,33.24
2021-02-15 00:00:00.000,전라북도,1453,793,745,708,48.73
2021-02-15 00:00:00.000,부산광역시,1329,718,691,638,48.01
2021-02-15 00:00:00.000,대전광역시,1197,699,679,518,43.27
2021-02-15 00:00:00.000,경기,829,572,444,385,46.44
2021-02-15 00:00:00.000,대구광역시,1020,544,486,534,52.35
2021-02-15 00:00:00.000,광주광역시,904,491,501,403,44.58
2021-02-15 00:00:00.000,제주특별자치도,767,383,396,371,48.37
2021-02-15 00:00:00.000,울산광역시,575,311,329,246,42.78
2021-02-15 00:00:00.000,세종특별자치시,398,239,199,199,50
2021-02-15 00:00:00.000,인천광역,136,99,80,56,41.18
2021-02-15 00:00:00.000,인천,97,71,56,41,42.27
2021-02-15 00:00:00.000,충남,61,47,40,21,34.43
2021-02-15 00:00:00.000,강원,69,43,30,39,56.52
2021-02-15 00:00:00.000,경남,76,43,32,44,57.89
2021-02-15 00:00:00.000,충북,63,41,28,35,55.56
2021-02-15 00:00:00.000,경북,58,38,27,31,53.45
2021-02-15 00:00:00.000,광주,45,31,20,25,55.56
2021-02-15 00:00:00.000,부산,48,31,24,24,50
2021-02-15 00:00:00.000,광주광역,29,26,22,7,24.14
2021-02-15 00:00:00.000,대전광역,35,23,18,17,48.57
2021-02-15 00:00:00.000,전남,38,20,16,22,57.89
2021-02-15 00:00:00.000,전북,30,20,19,11,36.67
2021-02-15 00:00:00.000,부산광역,39,20,21,18,46.15
2021-02-15 00:00:00.000,대전,31,20,11,20,64.52
2021-02-15 00:00:00.000,대구,20,16,13,7,35
2021-02-15 00:00:00.000,대구광역,26,16,11,15,57.69
2021-02-15 00:00:00.000,★★★★★★★★,22,15,9,13,59.09
2021-02-15 00:00:00.000,제주도,25,12,9,16,64
2021-02-15 00:00:00.000,제주,17,10,5,12,70.59
2021-02-15 00:00:00.000,울산광역,13,10,8,5,38.46
2021-02-15 00:00:00.000,서울강북구,14,10,9,5,35.71
2021-02-15 00:00:00.000,기,13,8,6,7,53.85
2021-02-15 00:00:00.000,울,12,8,4,8,66.67
2021-02-15 00:00:00.000,울산,10,7,2,8,80
2021-02-15 00:00:00.000,서울시,7,3,2,5,71.43
2021-02-15 00:00:00.000,산,9,3,1,8,88.89
2021-02-15 00:00:00.000,원주시,2,2,2,0,0
2021-02-15 00:00:00.000,천,1,1,1,0,0
2021-02-15 00:00:00.000,기도,1,1,1,0,0
2021-02-15 00:00:00.000,광주시,2,1,1,1,50
2021-02-15 00:00:00.000,경기도화성시송산동,1,1,1,0,0
2021-02-15 00:00:00.000,남,1,1,1,0,0
2021-02-15 00:00:00.000,서울관악구봉천1동,1,1,1,0,0
2021-02-22 00:00:00.000,서울특별시,50934,31694,28626,22308,43.8
2021-02-22 00:00:00.000,경기도,19002,11738,10745,8257,43.45
2021-02-22 00:00:00.000,인천광역시,3195,1875,1801,1394,43.63
2021-02-22 00:00:00.000,서울,2274,1601,1313,961,42.26
2021-02-22 00:00:00.000,충청남도,2329,1355,1288,1041,44.7
2021-02-22 00:00:00.000,경상북도,2083,1206,1144,939,45.08
2021-02-22 00:00:00.000,강원도,1827,1067,1008,819,44.83
2021-02-22 00:00:00.000,경상남도,1764,976,951,813,46.09
2021-02-22 00:00:00.000,충청북도,1409,817,808,601,42.65
2021-02-22 00:00:00.000,전라남도,1373,765,714,659,48
2021-02-22 00:00:00.000,전라북도,1319,761,710,609,46.17
2021-02-22 00:00:00.000,,953,754,659,294,30.85
2021-02-22 00:00:00.000,부산광역시,1361,715,712,649,47.69
2021-02-22 00:00:00.000,대전광역시,1100,618,616,484,44
2021-02-22 00:00:00.000,경기,797,549,444,353,44.29
2021-02-22 00:00:00.000,대구광역시,951,544,490,461,48.48
2021-02-22 00:00:00.000,광주광역시,920,485,482,438,47.61
2021-02-22 00:00:00.000,제주특별자치도,696,353,367,329,47.27
2021-02-22 00:00:00.000,울산광역시,529,287,288,241,45.56
2021-02-22 00:00:00.000,세종특별자치시,388,226,213,175,45.1
2021-02-22 00:00:00.000,인천광역,115,81,63,52,45.22
2021-02-22 00:00:00.000,충남,88,62,52,36,40.91
2021-02-22 00:00:00.000,인천,87,56,49,38,43.68
2021-02-22 00:00:00.000,경남,73,55,37,36,49.32
2021-02-22 00:00:00.000,강원,73,49,35,38,52.05
2021-02-22 00:00:00.000,경북,59,41,33,26,44.07
2021-02-22 00:00:00.000,충북,58,37,23,35,60.34
2021-02-22 00:00:00.000,전남,39,27,23,16,41.03
2021-02-22 00:00:00.000,부산광역,43,25,21,22,51.16
2021-02-22 00:00:00.000,광주,43,24,15,28,65.12
2021-02-22 00:00:00.000,대전,37,23,22,15,40.54
2021-02-22 00:00:00.000,대전광역,30,22,22,8,26.67
2021-02-22 00:00:00.000,★★★★★★★★,30,22,10,20,66.67
2021-02-22 00:00:00.000,전북,33,21,19,14,42.42
2021-02-22 00:00:00.000,부산,31,17,12,19,61.29
2021-02-22 00:00:00.000,대구광역,25,16,12,13,52
2021-02-22 00:00:00.000,광주광역,23,15,13,10,43.48
2021-02-22 00:00:00.000,대구,19,14,13,6,31.58
2021-02-22 00:00:00.000,제주도,17,11,3,14,82.35
2021-02-22 00:00:00.000,울산,15,10,8,7,46.67
2021-02-22 00:00:00.000,제주,8,7,6,2,25
2021-02-22 00:00:00.000,울,8,6,5,3,37.5
2021-02-22 00:00:00.000,서울강북구,6,5,4,2,33.33
2021-02-22 00:00:00.000,울산광역,4,4,3,1,25
2021-02-22 00:00:00.000,기,5,4,2,3,60
2021-02-22 00:00:00.000,서울시,5,3,3,2,40
2021-02-22 00:00:00.000,산,5,3,3,2,40
2021-02-22 00:00:00.000,남,1,1,1,0,0
2021-02-22 00:00:00.000,인헌12다길,5,1,1,4,80
2021-02-22 00:00:00.000,광주시,1,1,1,0,0
2021-02-22 00:00:00.000,서초구,2,1,1,1,50
2021-02-22 00:00:00.000,주,1,1,1,0,0
2021-02-22 00:00:00.000,경기양평군양서면,1,1,1,0,0
2021-02-22 00:00:00.000,원주시,4,1,0,4,100
2021-02-22 00:00:00.000,천,3,1,0,3,100
2021-03-01 00:00:00.000,서울특별시,41409,26625,22771,18638,45.01
2021-03-01 00:00:00.000,경기도,15106,9526,8326,6780,44.88
2021-03-01 00:00:00.000,인천광역시,2566,1552,1381,1185,46.18
2021-03-01 00:00:00.000,서울,1854,1337,1057,797,42.99
2021-03-01 00:00:00.000,충청남도,1871,1117,982,889,47.51
2021-03-01 00:00:00.000,경상북도,1702,977,890,812,47.71
2021-03-01 00:00:00.000,강원도,1500,905,822,678,45.2
2021-03-01 00:00:00.000,경상남도,1210,719,639,571,47.19
2021-03-01 00:00:00.000,충청북도,1075,644,582,493,45.86
2021-03-01 00:00:00.000,,787,641,552,235,29.86
2021-03-01 00:00:00.000,전라남도,1050,617,572,478,45.52
2021-03-01 00:00:00.000,전라북도,1100,617,551,549,49.91
2021-03-01 00:00:00.000,부산광역시,1010,568,522,488,48.32
2021-03-01 00:00:00.000,대전광역시,876,533,474,402,45.89
2021-03-01 00:00:00.000,경기,600,436,342,258,43
2021-03-01 00:00:00.000,대구광역시,698,401,379,319,45.7
2021-03-01 00:00:00.000,광주광역시,695,383,398,297,42.73
2021-03-01 00:00:00.000,제주특별자치도,561,312,277,284,50.62
2021-03-01 00:00:00.000,울산광역시,443,256,243,200,45.15
2021-03-01 00:00:00.000,세종특별자치시,334,192,181,153,45.81
2021-03-01 00:00:00.000,인천,96,62,47,49,51.04
2021-03-01 00:00:00.000,인천광역,71,57,44,27,38.03
2021-03-01 00:00:00.000,경북,60,37,33,27,45
2021-03-01 00:00:00.000,충남,54,34,27,27,50
2021-03-01 00:00:00.000,경남,63,33,25,38,60.32
2021-03-01 00:00:00.000,강원,46,33,23,23,50
2021-03-01 00:00:00.000,부산,39,25,28,11,28.21
2021-03-01 00:00:00.000,부산광역,34,23,21,13,38.24
2021-03-01 00:00:00.000,광주,32,20,17,15,46.88
2021-03-01 00:00:00.000,충북,27,18,16,11,40.74
2021-03-01 00:00:00.000,★★★★★★★★,22,17,10,12,54.55
2021-03-01 00:00:00.000,전북,22,15,13,9,40.91
2021-03-01 00:00:00.000,제주,28,14,18,10,35.71
2021-03-01 00:00:00.000,광주광역,22,14,14,8,36.36
2021-03-01 00:00:00.000,대전,22,12,11,11,50
2021-03-01 00:00:00.000,전남,16,11,8,8,50
2021-03-01 00:00:00.000,대전광역,12,11,10,2,16.67
2021-03-01 00:00:00.000,제주도,13,9,6,7,53.85
2021-03-01 00:00:00.000,서울강북구,15,9,4,11,73.33
2021-03-01 00:00:00.000,대구,8,8,6,2,25
2021-03-01 00:00:00.000,대구광역,10,8,9,1,10
2021-03-01 00:00:00.000,울,12,7,8,4,33.33
2021-03-01 00:00:00.000,울산,6,5,4,2,33.33
2021-03-01 00:00:00.000,기,4,4,3,1,25
2021-03-01 00:00:00.000,울산광역,5,4,3,2,40
2021-03-01 00:00:00.000,산,1,1,0,1,100
2021-03-01 00:00:00.000,원주시,1,1,1,0,0
2021-03-01 00:00:00.000,남,2,1,0,2,100
2021-03-01 00:00:00.000,서울시,1,1,0,1,100
2021-03-01 00:00:00.000,광주시,2,1,1,1,50
2021-03-01 00:00:00.000,인헌12다길,1,1,1,0,0
2021-03-01 00:00:00.000,인천직할시,1,1,1,0,0
2021-03-08 00:00:00.000,서울특별시,50164,31445,28100,22064,43.98
2021-03-08 00:00:00.000,경기도,18658,11372,10306,8352,44.76
2021-03-08 00:00:00.000,인천광역시,3076,1826,1709,1367,44.44
2021-03-08 00:00:00.000,서울,2251,1604,1329,922,40.96
2021-03-08 00:00:00.000,충청남도,2222,1339,1248,974,43.83
2021-03-08 00:00:00.000,경상북도,1946,1110,1044,902,46.35
2021-03-08 00:00:00.000,강원도,1679,1038,936,743,44.25
2021-03-08 00:00:00.000,경상남도,1727,917,858,869,50.32
2021-03-08 00:00:00.000,충청북도,1389,844,801,588,42.33
2021-03-08 00:00:00.000,,980,759,673,307,31.33
2021-03-08 00:00:00.000,전라북도,1330,742,685,645,48.5
2021-03-08 00:00:00.000,전라남도,1254,704,687,567,45.22
2021-03-08 00:00:00.000,부산광역시,1275,677,651,624,48.94
2021-03-08 00:00:00.000,대전광역시,1098,625,595,503,45.81
2021-03-08 00:00:00.000,대구광역시,905,539,508,397,43.87
2021-03-08 00:00:00.000,광주광역시,944,490,473,471,49.89
2021-03-08 00:00:00.000,경기,717,487,410,307,42.82
2021-03-08 00:00:00.000,제주특별자치도,724,378,376,348,48.07
2021-03-08 00:00:00.000,울산광역시,472,277,251,221,46.82
2021-03-08 00:00:00.000,세종특별자치시,381,213,214,167,43.83
2021-03-08 00:00:00.000,인천광역,124,93,72,52,41.94
2021-03-08 00:00:00.000,인천,91,70,61,30,32.97
2021-03-08 00:00:00.000,충남,89,62,50,39,43.82
2021-03-08 00:00:00.000,강원,71,44,32,39,54.93
2021-03-08 00:00:00.000,경남,75,41,44,31,41.33
2021-03-08 00:00:00.000,경북,53,36,32,21,39.62
2021-03-08 00:00:00.000,부산광역,46,32,30,16,34.78
2021-03-08 00:00:00.000,광주광역,46,31,22,24,52.17
2021-03-08 00:00:00.000,대전,35,26,20,15,42.86
2021-03-08 00:00:00.000,충북,32,23,22,10,31.25
2021-03-08 00:00:00.000,전북,33,23,26,7,21.21
2021-03-08 00:00:00.000,부산,33,22,18,15,45.45
2021-03-08 00:00:00.000,전남,30,22,18,12,40
2021-03-08 00:00:00.000,제주,22,17,12,10,45.45
2021-03-08 00:00:00.000,대전광역,26,16,10,16,61.54
2021-03-08 00:00:00.000,★★★★★★★★,18,14,13,5,27.78
2021-03-08 00:00:00.000,대구광역,24,12,11,13,54.17
2021-03-08 00:00:00.000,대구,23,12,11,12,52.17
2021-03-08 00:00:00.000,서울강북구,17,11,10,7,41.18
2021-03-08 00:00:00.000,광주,16,11,10,6,37.5
2021-03-08 00:00:00.000,제주도,12,10,10,2,16.67
2021-03-08 00:00:00.000,울산광역,11,8,6,5,45.45
2021-03-08 00:00:00.000,울산,15,8,9,6,40
2021-03-08 00:00:00.000,울,9,7,5,4,44.44
2021-03-08 00:00:00.000,천,7,5,6,1,14.29
2021-03-08 00:00:00.000,남,6,4,2,4,66.67
2021-03-08 00:00:00.000,산,4,2,2,2,50
2021-03-08 00:00:00.000,서울시,4,2,0,4,100
2021-03-08 00:00:00.000,기,3,2,0,3,100
2021-03-08 00:00:00.000,인헌12다길,1,1,1,0,0
2021-03-08 00:00:00.000,서울강북구번3동,1,1,1,0,0
2021-03-08 00:00:00.000,경기도화성시송산동,1,1,1,0,0
2021-03-08 00:00:00.000,주,1,1,0,1,100
2021-03-08 00:00:00.000,서대문구,1,1,1,0,0
2021-03-15 00:00:00.000,서울특별시,49193,30751,27554,21639,43.99
2021-03-15 00:00:00.000,경기도,18399,11266,10339,8060,43.81
2021-03-15 00:00:00.000,인천광역시,3197,1856,1749,1448,45.29
2021-03-15 00:00:00.000,서울,2246,1581,1295,951,42.34
2021-03-15 00:00:00.000,충청남도,2152,1262,1172,980,45.54
2021-03-15 00:00:00.000,경상북도,1953,1127,1040,913,46.75
2021-03-15 00:00:00.000,강원도,1732,1012,975,757,43.71
2021-03-15 00:00:00.000,경상남도,1610,861,812,798,49.57
2021-03-15 00:00:00.000,충청북도,1385,816,738,647,46.71
2021-03-15 00:00:00.000,,997,786,656,341,34.2
2021-03-15 00:00:00.000,전라남도,1370,741,700,670,48.91
2021-03-15 00:00:00.000,전라북도,1287,734,693,594,46.15
2021-03-15 00:00:00.000,부산광역시,1284,673,638,646,50.31
2021-03-15 00:00:00.000,대전광역시,1056,618,581,475,44.98
2021-03-15 00:00:00.000,경기,751,521,419,332,44.21
2021-03-15 00:00:00.000,광주광역시,855,467,471,384,44.91
2021-03-15 00:00:00.000,대구광역시,800,451,401,399,49.88
2021-03-15 00:00:00.000,제주특별자치도,742,393,375,367,49.46
2021-03-15 00:00:00.000,울산광역시,473,268,267,206,43.55
2021-03-15 00:00:00.000,세종특별자치시,354,213,202,152,42.94
2021-03-15 00:00:00.000,인천광역,132,102,83,49,37.12
2021-03-15 00:00:00.000,충남,85,59,49,36,42.35
2021-03-15 00:00:00.000,강원,59,47,34,25,42.37
2021-03-15 00:00:00.000,인천,60,43,37,23,38.33
2021-03-15 00:00:00.000,경남,63,41,32,31,49.21
2021-03-15 00:00:00.000,경북,63,39,37,26,41.27
2021-03-15 00:00:00.000,충북,48,31,24,24,50
2021-03-15 00:00:00.000,전남,49,27,22,27,55.1
2021-03-15 00:00:00.000,광주광역,30,23,15,15,50
2021-03-15 00:00:00.000,부산광역,33,21,11,22,66.67
2021-03-15 00:00:00.000,부산,29,20,12,17,58.62
2021-03-15 00:00:00.000,★★★★★★★★,27,20,11,16,59.26
2021-03-15 00:00:00.000,제주,24,17,12,12,50
2021-03-15 00:00:00.000,대구,24,16,14,10,41.67
2021-03-15 00:00:00.000,대전광역,27,16,16,11,40.74
2021-03-15 00:00:00.000,전북,20,16,16,4,20
2021-03-15 00:00:00.000,광주,22,15,13,9,40.91
2021-03-15 00:00:00.000,대전,25,15,14,11,44
2021-03-15 00:00:00.000,대구광역,22,14,12,10,45.45
2021-03-15 00:00:00.000,울산광역,21,12,9,12,57.14
2021-03-15 00:00:00.000,서울강북구,10,9,7,3,30
2021-03-15 00:00:00.000,울산,11,9,5,6,54.55
2021-03-15 00:00:00.000,제주도,10,8,6,4,40
2021-03-15 00:00:00.000,울,10,7,6,4,40
2021-03-15 00:00:00.000,기,6,5,3,3,50
2021-03-15 00:00:00.000,서울시,3,3,2,1,33.33
2021-03-15 00:00:00.000,남,3,2,2,1,33.33
2021-03-15 00:00:00.000,주,2,2,2,0,0
2021-03-22 00:00:00.000,서울특별시,49276,31106,27749,21527,43.69
2021-03-22 00:00:00.000,경기도,18505,11298,10372,8133,43.95
2021-03-22 00:00:00.000,인천광역시,3143,1835,1696,1447,46.04
2021-03-22 00:00:00.000,서울,2138,1524,1206,932,43.59
2021-03-22 00:00:00.000,충청남도,2167,1292,1207,960,44.3
2021-03-22 00:00:00.000,경상북도,2159,1184,1112,1047,48.49
2021-03-22 00:00:00.000,강원도,1761,1047,975,786,44.63
2021-03-22 00:00:00.000,경상남도,1672,926,839,833,49.82
2021-03-22 00:00:00.000,,1030,815,699,331,32.14
2021-03-22 00:00:00.000,충청북도,1316,777,733,583,44.3
2021-03-22 00:00:00.000,전라북도,1252,702,650,602,48.08
2021-03-22 00:00:00.000,전라남도,1233,695,644,589,47.77
2021-03-22 00:00:00.000,부산광역시,1248,682,638,610,48.88
2021-03-22 00:00:00.000,대전광역시,1042,592,569,473,45.39
2021-03-22 00:00:00.000,경기,787,568,427,360,45.74
2021-03-22 00:00:00.000,대구광역시,864,507,465,399,46.18
2021-03-22 00:00:00.000,광주광역시,814,443,410,404,49.63
2021-03-22 00:00:00.000,제주특별자치도,723,375,393,330,45.64
2021-03-22 00:00:00.000,울산광역시,507,270,264,243,47.93
2021-03-22 00:00:00.000,세종특별자치시,368,213,203,165,44.84
2021-03-22 00:00:00.000,인천광역,124,93,75,49,39.52
2021-03-22 00:00:00.000,충남,73,53,47,26,35.62
2021-03-22 00:00:00.000,인천,66,50,39,27,40.91
2021-03-22 00:00:00.000,경북,59,40,32,27,45.76
2021-03-22 00:00:00.000,강원,54,38,31,23,42.59
2021-03-22 00:00:00.000,경남,54,37,33,21,38.89
2021-03-22 00:00:00.000,충북,49,34,21,28,57.14
2021-03-22 00:00:00.000,★★★★★★★★,29,26,19,10,34.48
2021-03-22 00:00:00.000,전남,38,23,16,22,57.89
2021-03-22 00:00:00.000,부산,37,22,10,27,72.97
2021-03-22 00:00:00.000,광주광역,33,19,16,17,51.52
2021-03-22 00:00:00.000,대구광역,25,18,8,17,68
2021-03-22 00:00:00.000,부산광역,22,18,14,8,36.36
2021-03-22 00:00:00.000,전북,20,17,12,8,40
2021-03-22 00:00:00.000,광주,21,16,17,4,19.05
2021-03-22 00:00:00.000,대전광역,23,16,11,12,52.17
2021-03-22 00:00:00.000,대전,20,15,10,10,50
2021-03-22 00:00:00.000,대구,15,13,9,6,40
2021-03-22 00:00:00.000,제주도,16,10,6,10,62.5
2021-03-22 00:00:00.000,제주,14,9,7,7,50
2021-03-22 00:00:00.000,울산광역,10,7,9,1,10
2021-03-22 00:00:00.000,울산,9,7,8,1,11.11
2021-03-22 00:00:00.000,서울강북구,9,7,6,3,33.33
2021-03-22 00:00:00.000,울,8,7,7,1,12.5
2021-03-22 00:00:00.000,기,3,3,3,0,0
2021-03-22 00:00:00.000,서울시,4,3,1,3,75
2021-03-22 00:00:00.000,경기의왕시포일동,3,2,2,1,33.33
2021-03-22 00:00:00.000,남,2,2,2,0,0
2021-03-22 00:00:00.000,강북구,1,1,1,0,0
2021-03-22 00:00:00.000,산,1,1,1,0,0
2021-03-22 00:00:00.000,서울관악구봉천1동,1,1,1,0,0
2021-03-22 00:00:00.000,북,2,1,0,2,100
2021-03-29 00:00:00.000,서울특별시,47458,29856,26713,20745,43.71
2021-03-29 00:00:00.000,경기도,17592,10813,9850,7742,44.01
2021-03-29 00:00:00.000,인천광역시,2919,1737,1609,1310,44.88
2021-03-29 00:00:00.000,서울,2262,1560,1314,948,41.91
2021-03-29 00:00:00.000,충청남도,2175,1308,1213,962,44.23
2021-03-29 00:00:00.000,경상북도,1966,1076,1059,907,46.13
2021-03-29 00:00:00.000,강원도,1647,972,891,756,45.9
2021-03-29 00:00:00.000,경상남도,1534,873,812,722,47.07
2021-03-29 00:00:00.000,,1092,833,696,396,36.26
2021-03-29 00:00:00.000,충청북도,1293,772,731,562,43.46
2021-03-29 00:00:00.000,전라북도,1295,735,707,588,45.41
2021-03-29 00:00:00.000,전라남도,1282,693,647,635,49.53
2021-03-29 00:00:00.000,부산광역시,1191,669,644,547,45.93
2021-03-29 00:00:00.000,대전광역시,1072,601,548,524,48.88
2021-03-29 00:00:00.000,경기,742,522,420,322,43.4
2021-03-29 00:00:00.000,대구광역시,868,492,465,403,46.43
2021-03-29 00:00:00.000,광주광역시,764,413,412,352,46.07
2021-03-29 00:00:00.000,제주특별자치도,669,359,346,323,48.28
2021-03-29 00:00:00.000,울산광역시,520,292,282,238,45.77
2021-03-29 00:00:00.000,세종특별자치시,350,214,200,150,42.86
2021-03-29 00:00:00.000,인천광역,94,66,55,39,41.49
2021-03-29 00:00:00.000,충남,92,59,51,41,44.57
2021-03-29 00:00:00.000,강원,57,45,33,24,42.11
2021-03-29 00:00:00.000,경남,67,45,28,39,58.21
2021-03-29 00:00:00.000,경북,57,41,31,26,45.61
2021-03-29 00:00:00.000,인천,61,41,30,31,50.82
2021-03-29 00:00:00.000,충북,53,35,37,16,30.19
2021-03-29 00:00:00.000,부산광역,48,30,23,25,52.08
2021-03-29 00:00:00.000,전북,42,29,22,20,47.62
2021-03-29 00:00:00.000,부산,38,27,17,21,55.26
2021-03-29 00:00:00.000,광주광역,40,25,17,23,57.5
2021-03-29 00:00:00.000,전남,42,25,24,18,42.86
2021-03-29 00:00:00.000,대전,26,19,18,8,30.77
2021-03-29 00:00:00.000,광주,35,19,14,21,60
2021-03-29 00:00:00.000,대전광역,22,17,13,9,40.91
2021-03-29 00:00:00.000,대구광역,22,17,12,10,45.45
2021-03-29 00:00:00.000,★★★★★★★★,18,16,7,11,61.11
2021-03-29 00:00:00.000,제주,24,12,14,10,41.67
2021-03-29 00:00:00.000,대구,19,11,8,11,57.89
2021-03-29 00:00:00.000,울산광역,18,9,6,12,66.67
2021-03-29 00:00:00.000,서울강북구,9,8,7,2,22.22
2021-03-29 00:00:00.000,기,8,7,3,5,62.5
2021-03-29 00:00:00.000,울,9,6,5,4,44.44
2021-03-29 00:00:00.000,제주도,7,6,6,1,14.29
2021-03-29 00:00:00.000,울산,5,4,3,2,40
2021-03-29 00:00:00.000,남,3,3,3,0,0
2021-03-29 00:00:00.000,서울시,6,3,1,5,83.33
2021-03-29 00:00:00.000,산,6,1,6,0,0
2021-03-29 00:00:00.000,강북구,1,1,0,1,100
2021-03-29 00:00:00.000,서구,3,1,0,3,100
2021-03-29 00:00:00.000,서대문구,1,1,1,0,0
2021-04-05 00:00:00.000,서울특별시,48118,30156,26770,21348,44.37
2021-04-05 00:00:00.000,경기도,18431,11163,10238,8193,44.45
2021-04-05 00:00:00.000,인천광역시,3069,1794,1697,1372,44.71
2021-04-05 00:00:00.000,서울,2353,1672,1359,994,42.24
2021-04-05 00:00:00.000,,1866,1588,723,1143,61.25
2021-04-05 00:00:00.000,충청남도,2218,1318,1246,972,43.82
2021-04-05 00:00:00.000,경상북도,1950,1099,1090,860,44.1
2021-04-05 00:00:00.000,강원도,1664,992,941,723,43.45
2021-04-05 00:00:00.000,경상남도,1634,931,876,758,46.39
2021-04-05 00:00:00.000,충청북도,1308,775,723,585,44.72
2021-04-05 00:00:00.000,전라남도,1335,723,702,633,47.42
2021-04-05 00:00:00.000,전라북도,1274,714,685,589,46.23
2021-04-05 00:00:00.000,부산광역시,1228,668,636,592,48.21
2021-04-05 00:00:00.000,대전광역시,1073,587,551,522,48.65
2021-04-05 00:00:00.000,경기,715,502,391,324,45.31
2021-04-05 00:00:00.000,대구광역시,899,499,460,439,48.83
2021-04-05 00:00:00.000,광주광역시,806,435,420,386,47.89
2021-04-05 00:00:00.000,제주특별자치도,638,337,340,298,46.71
2021-04-05 00:00:00.000,울산광역시,528,286,282,246,46.59
2021-04-05 00:00:00.000,세종특별자치시,330,185,177,153,46.36
2021-04-05 00:00:00.000,인천광역,115,86,70,45,39.13
2021-04-05 00:00:00.000,인천,69,50,36,33,47.83
2021-04-05 00:00:00.000,경남,70,47,36,34,48.57
2021-04-05 00:00:00.000,경북,71,47,46,25,35.21
2021-04-05 00:00:00.000,충남,67,46,42,25,37.31
2021-04-05 00:00:00.000,강원,57,36,36,21,36.84
2021-04-05 00:00:00.000,충북,49,34,25,24,48.98
2021-04-05 00:00:00.000,대전광역,38,26,18,20,52.63
2021-04-05 00:00:00.000,부산광역,28,23,18,10,35.71
2021-04-05 00:00:00.000,전남,38,22,15,23,60.53
2021-04-05 00:00:00.000,광주광역,35,21,18,17,48.57
2021-04-05 00:00:00.000,전북,42,20,23,19,45.24
2021-04-05 00:00:00.000,부산,30,20,16,14,46.67
2021-04-05 00:00:00.000,광주,21,14,10,11,52.38
2021-04-05 00:00:00.000,대구광역,21,14,13,8,38.1
2021-04-05 00:00:00.000,★★★★★★★★,19,13,10,9,47.37
2021-04-05 00:00:00.000,대전,19,13,8,11,57.89
2021-04-05 00:00:00.000,대구,21,13,13,8,38.1
2021-04-05 00:00:00.000,제주,20,10,10,10,50
2021-04-05 00:00:00.000,울산광역,14,9,6,8,57.14
2021-04-05 00:00:00.000,제주도,7,7,5,2,28.57
2021-04-05 00:00:00.000,기,10,6,5,5,50
2021-04-05 00:00:00.000,울산,11,6,4,7,63.64
2021-04-05 00:00:00.000,서울시,8,3,4,4,50
2021-04-05 00:00:00.000,울,3,3,3,0,0
2021-04-05 00:00:00.000,서울강북구,7,3,3,4,57.14
2021-04-05 00:00:00.000,북,2,1,1,1,50
2021-04-05 00:00:00.000,남,1,1,1,0,0
2021-04-05 00:00:00.000,서구,4,1,1,3,75
2021-04-05 00:00:00.000,천,2,1,1,1,50
2021-04-05 00:00:00.000,광주시,2,1,1,1,50
2021-04-05 00:00:00.000,산,3,1,2,1,33.33
2021-04-05 00:00:00.000,광진구,1,1,0,1,100
2021-04-12 00:00:00.000,서울특별시,48803,30693,27275,21528,44.11
2021-04-12 00:00:00.000,경기도,18514,11354,10165,8349,45.1
2021-04-12 00:00:00.000,인천광역시,3172,1843,1732,1440,45.4
2021-04-12 00:00:00.000,서울,2328,1639,1315,1013,43.51
2021-04-12 00:00:00.000,충청남도,2210,1326,1215,995,45.02
2021-04-12 00:00:00.000,경상북도,2032,1131,1100,932,45.87
2021-04-12 00:00:00.000,강원도,1800,1049,944,856,47.56
2021-04-12 00:00:00.000,경상남도,1577,880,795,782,49.59
2021-04-12 00:00:00.000,,1120,873,768,352,31.43
2021-04-12 00:00:00.000,충청북도,1344,800,717,627,46.65
2021-04-12 00:00:00.000,전라남도,1314,718,631,683,51.98
2021-04-12 00:00:00.000,부산광역시,1277,705,672,605,47.38
2021-04-12 00:00:00.000,전라북도,1239,686,660,579,46.73
2021-04-12 00:00:00.000,대전광역시,1114,632,566,548,49.19
2021-04-12 00:00:00.000,경기,730,528,427,303,41.51
2021-04-12 00:00:00.000,대구광역시,916,503,468,448,48.91
2021-04-12 00:00:00.000,광주광역시,817,446,415,402,49.2
2021-04-12 00:00:00.000,제주특별자치도,678,378,363,315,46.46
2021-04-12 00:00:00.000,울산광역시,559,296,299,260,46.51
2021-04-12 00:00:00.000,세종특별자치시,321,188,181,140,43.61
2021-04-12 00:00:00.000,인천광역,100,76,59,41,41
2021-04-12 00:00:00.000,인천,76,60,50,26,34.21
2021-04-12 00:00:00.000,충남,88,55,40,48,54.55
2021-04-12 00:00:00.000,경북,62,43,32,30,48.39
2021-04-12 00:00:00.000,강원,59,42,38,21,35.59
2021-04-12 00:00:00.000,충북,60,40,24,36,60
2021-04-12 00:00:00.000,경남,55,38,31,24,43.64
2021-04-12 00:00:00.000,전북,41,27,18,23,56.1
2021-04-12 00:00:00.000,★★★★★★★★,39,26,20,19,48.72
2021-04-12 00:00:00.000,전남,38,23,24,14,36.84
2021-04-12 00:00:00.000,광주광역,32,22,21,11,34.38
2021-04-12 00:00:00.000,부산,30,21,18,12,40
2021-04-12 00:00:00.000,부산광역,32,20,13,19,59.38
2021-04-12 00:00:00.000,대구광역,27,19,15,12,44.44
2021-04-12 00:00:00.000,대구,27,17,15,12,44.44
2021-04-12 00:00:00.000,광주,28,16,13,15,53.57
2021-04-12 00:00:00.000,울산,24,15,13,11,45.83
2021-04-12 00:00:00.000,대전광역,17,13,12,5,29.41
2021-04-12 00:00:00.000,대전,22,13,8,14,63.64
2021-04-12 00:00:00.000,제주,15,11,9,6,40
2021-04-12 00:00:00.000,서울강북구,13,10,9,4,30.77
2021-04-12 00:00:00.000,울산광역,14,8,5,9,64.29
2021-04-12 00:00:00.000,제주도,8,6,5,3,37.5
2021-04-12 00:00:00.000,서울시,7,5,3,4,57.14
2021-04-12 00:00:00.000,울,8,4,5,3,37.5
2021-04-12 00:00:00.000,기,7,3,3,4,57.14
2021-04-12 00:00:00.000,주,1,1,1,0,0
2021-04-12 00:00:00.000,원,1,1,1,0,0
2021-04-12 00:00:00.000,남,2,1,2,0,0
2021-04-12 00:00:00.000,강북구,2,1,1,1,50
2021-04-12 00:00:00.000,광진구,1,1,1,0,0
2021-04-12 00:00:00.000,산,2,1,2,0,0
2021-04-19 00:00:00.000,서울특별시,49360,31075,27848,21512,43.58
2021-04-19 00:00:00.000,경기도,18681,11392,10512,8169,43.73
2021-04-19 00:00:00.000,인천광역시,3081,1882,1701,1380,44.79
2021-04-19 00:00:00.000,서울,2273,1589,1332,941,41.4
2021-04-19 00:00:00.000,충청남도,2249,1383,1329,920,40.91
2021-04-19 00:00:00.000,경상북도,2089,1187,1167,922,44.14
2021-04-19 00:00:00.000,강원도,1746,1015,955,791,45.3
2021-04-19 00:00:00.000,경상남도,1675,922,880,795,47.46
2021-04-19 00:00:00.000,충청북도,1450,873,834,616,42.48
2021-04-19 00:00:00.000,,1117,851,706,411,36.79
2021-04-19 00:00:00.000,전라남도,1428,819,764,664,46.5
2021-04-19 00:00:00.000,전라북도,1352,732,681,671,49.63
2021-04-19 00:00:00.000,부산광역시,1346,721,687,659,48.96
2021-04-19 00:00:00.000,대전광역시,1073,609,570,503,46.88
2021-04-19 00:00:00.000,대구광역시,977,533,488,489,50.05
2021-04-19 00:00:00.000,경기,732,503,400,332,45.36
2021-04-19 00:00:00.000,광주광역시,765,451,432,333,43.53
2021-04-19 00:00:00.000,제주특별자치도,658,350,381,277,42.1
2021-04-19 00:00:00.000,울산광역시,531,301,261,270,50.85
2021-04-19 00:00:00.000,세종특별자치시,363,211,187,176,48.48
2021-04-19 00:00:00.000,인천광역,132,95,83,49,37.12
2021-04-19 00:00:00.000,충남,85,65,54,31,36.47
2021-04-19 00:00:00.000,경북,103,59,54,49,47.57
2021-04-19 00:00:00.000,인천,66,48,34,32,48.48
2021-04-19 00:00:00.000,전북,71,43,35,36,50.7
2021-04-19 00:00:00.000,충북,53,40,29,24,45.28
2021-04-19 00:00:00.000,경남,63,36,21,42,66.67
2021-04-19 00:00:00.000,강원,40,29,21,19,47.5
2021-04-19 00:00:00.000,부산광역,42,26,17,25,59.52
2021-04-19 00:00:00.000,대전광역,37,26,16,21,56.76
2021-04-19 00:00:00.000,대전,41,22,24,17,41.46
2021-04-19 00:00:00.000,★★★★★★★★,37,22,17,20,54.05
2021-04-19 00:00:00.000,전남,37,21,21,16,43.24
2021-04-19 00:00:00.000,대구,25,20,16,9,36
2021-04-19 00:00:00.000,광주,37,20,15,22,59.46
2021-04-19 00:00:00.000,광주광역,24,19,14,10,41.67
2021-04-19 00:00:00.000,부산,23,15,10,13,56.52
2021-04-19 00:00:00.000,대구광역,18,13,8,10,55.56
2021-04-19 00:00:00.000,울산,19,12,13,6,31.58
2021-04-19 00:00:00.000,울,10,9,4,6,60
2021-04-19 00:00:00.000,제주도,16,9,8,8,50
2021-04-19 00:00:00.000,제주,10,8,8,2,20
2021-04-19 00:00:00.000,울산광역,7,7,7,0,0
2021-04-19 00:00:00.000,서울시,5,4,3,2,40
2021-04-19 00:00:00.000,기,5,4,2,3,60
2021-04-19 00:00:00.000,남,5,3,1,4,80
2021-04-19 00:00:00.000,원,3,2,2,1,33.33
2021-04-19 00:00:00.000,서울강북구,3,2,2,1,33.33
2021-04-19 00:00:00.000,천,1,1,1,0,0
2021-04-19 00:00:00.000,강북구,1,1,1,0,0
2021-04-19 00:00:00.000,산,2,1,1,1,50
2021-04-19 00:00:00.000,주공아파트,1,1,1,0,0
2021-04-19 00:00:00.000,세종시,2,1,2,0,0
2021-04-19 00:00:00.000,경기도양주군회천읍,1,1,0,1,100
2021-04-26 00:00:00.000,서울특별시,48235,30361,27272,20963,43.46
2021-04-26 00:00:00.000,경기도,17807,11082,10195,7612,42.75
2021-04-26 00:00:00.000,인천광역시,2972,1762,1670,1302,43.81
2021-04-26 00:00:00.000,서울,2212,1566,1322,890,40.24
2021-04-26 00:00:00.000,충청남도,2124,1291,1179,945,44.49
2021-04-26 00:00:00.000,경상북도,1974,1129,1065,909,46.05
2021-04-26 00:00:00.000,강원도,1884,1065,997,887,47.08
2021-04-26 00:00:00.000,경상남도,1652,899,872,780,47.22
2021-04-26 00:00:00.000,,1067,837,700,367,34.4
2021-04-26 00:00:00.000,충청북도,1392,819,761,631,45.33
2021-04-26 00:00:00.000,전라북도,1349,763,751,598,44.33
2021-04-26 00:00:00.000,부산광역시,1430,740,697,733,51.26
2021-04-26 00:00:00.000,전라남도,1307,727,726,581,44.45
2021-04-26 00:00:00.000,대전광역시,1078,640,592,486,45.08
2021-04-26 00:00:00.000,경기,693,495,388,305,44.01
2021-04-26 00:00:00.000,대구광역시,853,490,466,387,45.37
2021-04-26 00:00:00.000,광주광역시,761,407,397,364,47.83
2021-04-26 00:00:00.000,제주특별자치도,713,385,408,305,42.78
2021-04-26 00:00:00.000,울산광역시,541,291,275,266,49.17
2021-04-26 00:00:00.000,세종특별자치시,340,198,186,154,45.29
2021-04-26 00:00:00.000,인천광역,128,88,75,53,41.41
2021-04-26 00:00:00.000,충남,72,53,42,30,41.67
2021-04-26 00:00:00.000,경남,87,53,49,38,43.68
2021-04-26 00:00:00.000,경북,91,52,49,42,46.15
2021-04-26 00:00:00.000,인천,64,42,37,27,42.19
2021-04-26 00:00:00.000,강원,61,39,33,28,45.9
2021-04-26 00:00:00.000,충북,48,33,30,18,37.5
2021-04-26 00:00:00.000,전북,33,26,18,15,45.45
2021-04-26 00:00:00.000,대전광역,35,25,20,15,42.86
2021-04-26 00:00:00.000,부산광역,34,24,21,13,38.24
2021-04-26 00:00:00.000,전남,33,23,14,19,57.58
2021-04-26 00:00:00.000,★★★★★★★★,32,23,21,11,34.38
2021-04-26 00:00:00.000,광주,39,22,21,18,46.15
2021-04-26 00:00:00.000,대전,26,21,17,9,34.62
2021-04-26 00:00:00.000,광주광역,27,20,14,13,48.15
2021-04-26 00:00:00.000,대구광역,29,19,14,15,51.72
2021-04-26 00:00:00.000,부산,28,17,15,13,46.43
2021-04-26 00:00:00.000,울,17,13,11,6,35.29
2021-04-26 00:00:00.000,서울강북구,14,10,11,3,21.43
2021-04-26 00:00:00.000,울산,18,9,9,9,50
2021-04-26 00:00:00.000,울산광역,14,8,5,9,64.29
2021-04-26 00:00:00.000,대구,14,7,5,9,64.29
2021-04-26 00:00:00.000,제주도,9,7,8,1,11.11
2021-04-26 00:00:00.000,기,11,6,4,7,63.64
2021-04-26 00:00:00.000,제주,15,6,8,7,46.67
2021-04-26 00:00:00.000,남,5,3,2,3,60
2021-04-26 00:00:00.000,서울시,2,2,1,1,50
2021-04-26 00:00:00.000,강서구,3,1,0,3,100
2021-04-26 00:00:00.000,경기용인시풍덕천2동,1,1,1,0,0
2021-04-26 00:00:00.000,북,3,1,1,2,66.67
2021-04-26 00:00:00.000,강북구,1,1,1,0,0
2021-04-26 00:00:00.000,전,1,1,1,0,0
2021-04-26 00:00:00.000,산,2,1,0,2,100
2021-04-26 00:00:00.000,경기도화성시송산동,1,1,1,0,0
2021-04-26 00:00:00.000,강동구,1,1,1,0,0
2021-04-26 00:00:00.000,서울관악구봉천1동,1,1,1,0,0
2021-05-03 00:00:00.000,서울특별시,41410,26583,22221,19189,46.34
2021-05-03 00:00:00.000,경기도,15326,9619,8239,7087,46.24
2021-05-03 00:00:00.000,인천광역시,2571,1561,1357,1214,47.22
2021-05-03 00:00:00.000,서울,1846,1351,1027,819,44.37
2021-05-03 00:00:00.000,충청남도,1805,1100,958,847,46.93
2021-05-03 00:00:00.000,경상북도,1727,964,882,845,48.93
2021-05-03 00:00:00.000,강원도,1415,870,717,698,49.33
2021-05-03 00:00:00.000,경상남도,1293,709,676,617,47.72
2021-05-03 00:00:00.000,충청북도,1143,705,603,540,47.24
2021-05-03 00:00:00.000,,895,699,618,277,30.95
2021-05-03 00:00:00.000,전라북도,1064,615,563,501,47.09
2021-05-03 00:00:00.000,전라남도,1021,598,531,490,47.99
2021-05-03 00:00:00.000,부산광역시,1093,572,544,549,50.23
2021-05-03 00:00:00.000,대전광역시,881,512,457,424,48.13
2021-05-03 00:00:00.000,대구광역시,742,419,355,387,52.16
2021-05-03 00:00:00.000,경기,609,415,310,299,49.1
2021-05-03 00:00:00.000,광주광역시,648,369,332,316,48.77
2021-05-03 00:00:00.000,제주특별자치도,513,265,276,237,46.2
2021-05-03 00:00:00.000,울산광역시,460,258,254,206,44.78
2021-05-03 00:00:00.000,세종특별자치시,345,196,180,165,47.83
2021-05-03 00:00:00.000,인천광역,121,81,63,58,47.93
2021-05-03 00:00:00.000,인천,61,41,30,31,50.82
2021-05-03 00:00:00.000,충남,55,40,28,27,49.09
2021-05-03 00:00:00.000,경북,56,35,35,21,37.5
2021-05-03 00:00:00.000,강원,44,31,25,19,43.18
2021-05-03 00:00:00.000,전북,46,30,23,23,50
2021-05-03 00:00:00.000,경남,32,23,16,16,50
2021-05-03 00:00:00.000,충북,30,22,14,16,53.33
2021-05-03 00:00:00.000,광주광역,33,20,16,17,51.52
2021-05-03 00:00:00.000,전남,27,18,19,8,29.63
2021-05-03 00:00:00.000,★★★★★★★★,30,18,17,13,43.33
2021-05-03 00:00:00.000,부산광역,26,17,11,15,57.69
2021-05-03 00:00:00.000,부산,20,13,12,8,40
2021-05-03 00:00:00.000,대구광역,14,12,12,2,14.29
2021-05-03 00:00:00.000,대전,20,12,4,16,80
2021-05-03 00:00:00.000,대전광역,16,10,6,10,62.5
2021-05-03 00:00:00.000,울산,22,10,10,12,54.55
2021-05-03 00:00:00.000,대구,18,9,7,11,61.11
2021-05-03 00:00:00.000,광주,13,9,9,4,30.77
2021-05-03 00:00:00.000,제주도,8,6,6,2,25
2021-05-03 00:00:00.000,서울강북구,7,6,3,4,57.14
2021-05-03 00:00:00.000,울산광역,10,5,5,5,50
2021-05-03 00:00:00.000,울,11,5,3,8,72.73
2021-05-03 00:00:00.000,기,5,4,5,0,0
2021-05-03 00:00:00.000,제주,5,4,3,2,40
2021-05-03 00:00:00.000,주,1,1,1,0,0
2021-05-03 00:00:00.000,인헌12다길,2,1,1,1,50
2021-05-03 00:00:00.000,남,1,1,1,0,0
2021-05-03 00:00:00.000,산,2,1,2,0,0
2021-05-03 00:00:00.000,강북구,2,1,0,2,100
2021-05-03 00:00:00.000,서울시,1,1,0,1,100
2021-05-03 00:00:00.000,충부,2,1,0,2,100
2021-05-03 00:00:00.000,원,1,1,1,0,0
2021-05-10 00:00:00.000,서울특별시,50998,32222,28705,22293,43.71
2021-05-10 00:00:00.000,경기도,18825,11630,10650,8175,43.43
2021-05-10 00:00:00.000,인천광역시,3192,1924,1752,1440,45.11
2021-05-10 00:00:00.000,서울,2364,1659,1372,992,41.96
2021-05-10 00:00:00.000,충청남도,2251,1364,1277,974,43.27
2021-05-10 00:00:00.000,경상북도,2124,1181,1138,986,46.42
2021-05-10 00:00:00.000,강원도,1776,1057,955,821,46.23
2021-05-10 00:00:00.000,경상남도,1635,897,845,790,48.32
2021-05-10 00:00:00.000,,1136,880,711,425,37.41
2021-05-10 00:00:00.000,충청북도,1364,824,782,582,42.67
2021-05-10 00:00:00.000,부산광역시,1426,773,711,715,50.14
2021-05-10 00:00:00.000,전라북도,1352,771,716,636,47.04
2021-05-10 00:00:00.000,전라남도,1262,710,677,585,46.35
2021-05-10 00:00:00.000,대전광역시,1171,673,620,551,47.05
2021-05-10 00:00:00.000,경기,773,553,440,333,43.08
2021-05-10 00:00:00.000,대구광역시,1025,541,515,510,49.76
2021-05-10 00:00:00.000,광주광역시,848,467,450,398,46.93
2021-05-10 00:00:00.000,제주특별자치도,667,376,363,304,45.58
2021-05-10 00:00:00.000,울산광역시,528,294,281,247,46.78
2021-05-10 00:00:00.000,세종특별자치시,372,222,235,137,36.83
2021-05-10 00:00:00.000,인천광역,109,83,61,48,44.04
2021-05-10 00:00:00.000,충남,88,63,46,42,47.73
2021-05-10 00:00:00.000,인천,92,61,47,45,48.91
2021-05-10 00:00:00.000,강원,61,44,39,22,36.07
2021-05-10 00:00:00.000,경북,56,41,33,23,41.07
2021-05-10 00:00:00.000,충북,61,40,37,24,39.34
2021-05-10 00:00:00.000,경남,62,37,27,35,56.45
2021-05-10 00:00:00.000,전북,47,34,29,18,38.3
2021-05-10 00:00:00.000,부산광역,42,29,29,13,30.95
2021-05-10 00:00:00.000,대전광역,51,28,21,30,58.82
2021-05-10 00:00:00.000,부산,46,25,21,25,54.35
2021-05-10 00:00:00.000,광주,39,23,16,23,58.97
2021-05-10 00:00:00.000,대구광역,27,18,15,12,44.44
2021-05-10 00:00:00.000,★★★★★★★★,27,18,19,8,29.63
2021-05-10 00:00:00.000,전남,28,17,16,12,42.86
2021-05-10 00:00:00.000,대전,23,16,16,7,30.43
2021-05-10 00:00:00.000,광주광역,16,13,7,9,56.25
2021-05-10 00:00:00.000,울산,18,12,6,12,66.67
2021-05-10 00:00:00.000,제주도,25,11,11,14,56
2021-05-10 00:00:00.000,울산광역,14,11,8,6,42.86
2021-05-10 00:00:00.000,서울강북구,11,10,10,1,9.09
2021-05-10 00:00:00.000,대구,13,10,7,6,46.15
2021-05-10 00:00:00.000,울,7,6,6,1,14.29
2021-05-10 00:00:00.000,남,6,5,5,1,16.67
2021-05-10 00:00:00.000,제주,9,5,5,4,44.44
2021-05-10 00:00:00.000,서울시,4,3,3,1,25
2021-05-10 00:00:00.000,천,2,2,2,0,0
2021-05-10 00:00:00.000,북,3,2,1,2,66.67
2021-05-10 00:00:00.000,산,2,2,0,2,100
2021-05-10 00:00:00.000,강서구,1,1,1,0,0
2021-05-10 00:00:00.000,부산시,1,1,1,0,0
2021-05-10 00:00:00.000,광주시,2,1,1,1,50
2021-05-10 00:00:00.000,전,2,1,0,2,100
2021-05-10 00:00:00.000,기,2,1,0,2,100
2021-05-17 00:00:00.000,서울특별시,41282,26741,22683,18599,45.05
2021-05-17 00:00:00.000,경기도,15033,9481,8220,6813,45.32
2021-05-17 00:00:00.000,인천광역시,2588,1590,1462,1126,43.51
2021-05-17 00:00:00.000,서울,1860,1343,1070,790,42.47
2021-05-17 00:00:00.000,충청남도,1945,1174,1069,876,45.04
2021-05-17 00:00:00.000,경상북도,1770,1006,920,850,48.02
2021-05-17 00:00:00.000,강원도,1430,853,744,686,47.97
2021-05-17 00:00:00.000,경상남도,1361,750,704,657,48.27
2021-05-17 00:00:00.000,,897,744,679,218,24.3
2021-05-17 00:00:00.000,충청북도,1157,714,660,497,42.96
2021-05-17 00:00:00.000,부산광역시,1179,651,577,602,51.06
2021-05-17 00:00:00.000,전라남도,1047,610,576,471,44.99
2021-05-17 00:00:00.000,전라북도,1112,608,553,559,50.27
2021-05-17 00:00:00.000,대전광역시,969,571,520,449,46.34
2021-05-17 00:00:00.000,대구광역시,794,450,412,382,48.11
2021-05-17 00:00:00.000,경기,622,445,327,295,47.43
2021-05-17 00:00:00.000,광주광역시,663,371,346,317,47.81
2021-05-17 00:00:00.000,제주특별자치도,508,296,266,242,47.64
2021-05-17 00:00:00.000,울산광역시,402,231,218,184,45.77
2021-05-17 00:00:00.000,세종특별자치시,287,179,159,128,44.6
2021-05-17 00:00:00.000,인천광역,84,60,46,38,45.24
2021-05-17 00:00:00.000,충남,87,50,46,41,47.13
2021-05-17 00:00:00.000,인천,64,44,25,39,60.94
2021-05-17 00:00:00.000,경북,55,32,26,29,52.73
2021-05-17 00:00:00.000,경남,43,31,27,16,37.21
2021-05-17 00:00:00.000,강원,46,31,25,21,45.65
2021-05-17 00:00:00.000,충북,40,28,23,17,42.5
2021-05-17 00:00:00.000,부산,37,24,19,18,48.65
2021-05-17 00:00:00.000,전북,37,22,19,18,48.65
2021-05-17 00:00:00.000,대전광역,34,20,18,16,47.06
2021-05-17 00:00:00.000,광주광역,27,19,17,10,37.04
2021-05-17 00:00:00.000,전남,23,17,15,8,34.78
2021-05-17 00:00:00.000,부산광역,21,15,8,13,61.9
2021-05-17 00:00:00.000,대구광역,17,15,12,5,29.41
2021-05-17 00:00:00.000,대전,25,15,14,11,44
2021-05-17 00:00:00.000,★★★★★★★★,18,15,8,10,55.56
2021-05-17 00:00:00.000,울산,16,11,11,5,31.25
2021-05-17 00:00:00.000,대구,16,10,5,11,68.75
2021-05-17 00:00:00.000,제주,17,9,5,12,70.59
2021-05-17 00:00:00.000,광주,14,9,10,4,28.57
2021-05-17 00:00:00.000,제주도,11,8,6,5,45.45
2021-05-17 00:00:00.000,서울강북구,8,8,7,1,12.5
2021-05-17 00:00:00.000,울산광역,7,5,4,3,42.86
2021-05-17 00:00:00.000,기,5,4,1,4,80
2021-05-17 00:00:00.000,울,6,4,4,2,33.33
2021-05-17 00:00:00.000,산,5,3,4,1,20
2021-05-17 00:00:00.000,서울시,4,2,0,4,100
2021-05-17 00:00:00.000,서울관악구봉천1동,2,2,1,1,50
2021-05-17 00:00:00.000,원주시,1,1,0,1,100
2021-05-17 00:00:00.000,강북구,1,1,1,0,0
2021-05-17 00:00:00.000,충부,1,1,1,0,0
2021-05-24 00:00:00.000,서울특별시,50978,31958,28433,22545,44.22
2021-05-24 00:00:00.000,경기도,18191,11365,10234,7957,43.74
2021-05-24 00:00:00.000,인천광역시,3347,1957,1827,1520,45.41
2021-05-24 00:00:00.000,서울,2308,1606,1346,962,41.68
2021-05-24 00:00:00.000,충청남도,2245,1354,1263,982,43.74
2021-05-24 00:00:00.000,경상북도,2081,1130,1077,1004,48.25
2021-05-24 00:00:00.000,강원도,1840,1073,1009,831,45.16
2021-05-24 00:00:00.000,경상남도,1751,914,884,867,49.51
2021-05-24 00:00:00.000,충청북도,1501,875,822,679,45.24
2021-05-24 00:00:00.000,,1078,838,732,346,32.1
2021-05-24 00:00:00.000,부산광역시,1413,789,774,639,45.22
2021-05-24 00:00:00.000,전라북도,1365,774,760,605,44.32
2021-05-24 00:00:00.000,전라남도,1313,715,707,606,46.15
2021-05-24 00:00:00.000,대전광역시,1109,647,615,494,44.54
2021-05-24 00:00:00.000,대구광역시,1008,538,551,457,45.34
2021-05-24 00:00:00.000,경기,780,533,444,336,43.08
2021-05-24 00:00:00.000,광주광역시,817,472,453,364,44.55
2021-05-24 00:00:00.000,제주특별자치도,702,384,370,332,47.29
2021-05-24 00:00:00.000,울산광역시,529,281,267,262,49.53
2021-05-24 00:00:00.000,세종특별자치시,375,231,207,168,44.8
2021-05-24 00:00:00.000,인천광역,121,88,64,57,47.11
2021-05-24 00:00:00.000,인천,105,65,58,47,44.76
2021-05-24 00:00:00.000,충남,75,51,45,30,40
2021-05-24 00:00:00.000,경북,81,47,42,39,48.15
2021-05-24 00:00:00.000,강원,50,40,33,17,34
2021-05-24 00:00:00.000,전북,59,38,41,18,30.51
2021-05-24 00:00:00.000,경남,50,32,26,24,48
2021-05-24 00:00:00.000,충북,49,30,26,23,46.94
2021-05-24 00:00:00.000,부산광역,48,27,26,22,45.83
2021-05-24 00:00:00.000,부산,33,24,15,18,54.55
2021-05-24 00:00:00.000,대전광역,34,24,16,18,52.94
2021-05-24 00:00:00.000,대전,40,22,16,24,60
2021-05-24 00:00:00.000,전남,34,22,22,12,35.29
2021-05-24 00:00:00.000,★★★★★★★★,26,19,7,19,73.08
2021-05-24 00:00:00.000,광주,25,18,20,5,20
2021-05-24 00:00:00.000,광주광역,34,18,14,20,58.82
2021-05-24 00:00:00.000,대구광역,25,16,12,13,52
2021-05-24 00:00:00.000,대구,21,14,12,9,42.86
2021-05-24 00:00:00.000,제주도,18,12,10,8,44.44
2021-05-24 00:00:00.000,울산광역,13,9,7,6,46.15
2021-05-24 00:00:00.000,제주,14,9,7,7,50
2021-05-24 00:00:00.000,울산,17,8,8,9,52.94
2021-05-24 00:00:00.000,울,9,7,6,3,33.33
2021-05-24 00:00:00.000,서울강북구,7,7,7,0,0
2021-05-24 00:00:00.000,서울시,6,4,2,4,66.67
2021-05-24 00:00:00.000,기,3,2,1,2,66.67
2021-05-24 00:00:00.000,남,6,2,2,4,66.67
2021-05-24 00:00:00.000,원,2,1,2,0,0
2021-05-24 00:00:00.000,산,6,1,5,1,16.67
2021-05-24 00:00:00.000,남동구만수2동,2,1,0,2,100
2021-05-24 00:00:00.000,서울관악구봉천1동,1,1,1,0,0
2021-05-24 00:00:00.000,천,1,1,0,1,100
2021-05-24 00:00:00.000,전,1,1,1,0,0
2021-05-24 00:00:00.000,원주시,1,1,1,0,0
2021-05-31 00:00:00.000,서울특별시,49700,31418,27423,22277,44.82
2021-05-31 00:00:00.000,경기도,18191,11220,10098,8093,44.49
2021-05-31 00:00:00.000,인천광역시,3118,1869,1732,1386,44.45
2021-05-31 00:00:00.000,서울,2292,1598,1292,1000,43.63
2021-05-31 00:00:00.000,충청남도,2088,1265,1165,923,44.2
2021-05-31 00:00:00.000,경상북도,2148,1198,1118,1030,47.95
2021-05-31 00:00:00.000,,1384,1149,736,648,46.82
2021-05-31 00:00:00.000,강원도,1741,1026,926,815,46.81
2021-05-31 00:00:00.000,경상남도,1706,883,873,833,48.83
2021-05-31 00:00:00.000,충청북도,1413,852,773,640,45.29
2021-05-31 00:00:00.000,전라북도,1286,730,693,593,46.11
2021-05-31 00:00:00.000,전라남도,1242,690,654,588,47.34
2021-05-31 00:00:00.000,부산광역시,1246,688,615,631,50.64
2021-05-31 00:00:00.000,대전광역시,1117,643,598,519,46.46
2021-05-31 00:00:00.000,경기,720,491,384,336,46.67
2021-05-31 00:00:00.000,대구광역시,915,487,446,469,51.26
2021-05-31 00:00:00.000,광주광역시,760,435,388,372,48.95
2021-05-31 00:00:00.000,제주특별자치도,708,363,375,333,47.03
2021-05-31 00:00:00.000,울산광역시,510,284,259,251,49.22
2021-05-31 00:00:00.000,세종특별자치시,427,232,233,194,45.43
2021-05-31 00:00:00.000,인천광역,140,92,75,65,46.43
2021-05-31 00:00:00.000,인천,81,57,49,32,39.51
2021-05-31 00:00:00.000,충남,76,52,44,32,42.11
2021-05-31 00:00:00.000,경북,62,41,33,29,46.77
2021-05-31 00:00:00.000,강원,58,40,35,23,39.66
2021-05-31 00:00:00.000,충북,40,31,21,19,47.5
2021-05-31 00:00:00.000,전북,51,29,20,31,60.78
2021-05-31 00:00:00.000,대전,40,22,25,15,37.5
2021-05-31 00:00:00.000,광주광역,31,22,14,17,54.84
2021-05-31 00:00:00.000,경남,29,21,14,15,51.72
2021-05-31 00:00:00.000,부산광역,33,20,16,17,51.52
2021-05-31 00:00:00.000,전남,27,20,9,18,66.67
2021-05-31 00:00:00.000,★★★★★★★★,22,19,9,13,59.09
2021-05-31 00:00:00.000,부산,27,18,16,11,40.74
2021-05-31 00:00:00.000,대구광역,29,17,19,10,34.48
2021-05-31 00:00:00.000,대전광역,20,17,12,8,40
2021-05-31 00:00:00.000,대구,26,16,16,10,38.46
2021-05-31 00:00:00.000,울산광역,18,12,11,7,38.89
2021-05-31 00:00:00.000,광주,18,12,6,12,66.67
2021-05-31 00:00:00.000,제주도,15,10,8,7,46.67
2021-05-31 00:00:00.000,울산,12,9,9,3,25
2021-05-31 00:00:00.000,제주,14,9,10,4,28.57
2021-05-31 00:00:00.000,울,9,8,7,2,22.22
2021-05-31 00:00:00.000,서울강북구,10,8,5,5,50
2021-05-31 00:00:00.000,기,7,4,4,3,42.86
2021-05-31 00:00:00.000,경기도화성시송산동,3,2,2,1,33.33
2021-05-31 00:00:00.000,강북구,3,2,1,2,66.67
2021-05-31 00:00:00.000,광주시,2,1,0,2,100
2021-05-31 00:00:00.000,경기용인시풍덕천2동,1,1,1,0,0
2021-05-31 00:00:00.000,서울관악구봉천1동,1,1,0,1,100
2021-05-31 00:00:00.000,주,2,1,0,2,100
2021-05-31 00:00:00.000,남,1,1,1,0,0
2021-05-31 00:00:00.000,서울시,1,1,0,1,100
2021-05-31 00:00:00.000,산,1,1,1,0,0
2021-05-31 00:00:00.000,남동구만수2동,1,1,1,0,0
2021-06-07 00:00:00.000,서울특별시,49720,31400,27373,22347,44.95
2021-06-07 00:00:00.000,경기도,18215,11175,9827,8388,46.05
2021-06-07 00:00:00.000,인천광역시,3079,1863,1697,1382,44.88
2021-06-07 00:00:00.000,서울,2266,1604,1324,942,41.57
2021-06-07 00:00:00.000,충청남도,2034,1213,1104,930,45.72
2021-06-07 00:00:00.000,경상북도,2030,1167,1079,951,46.85
2021-06-07 00:00:00.000,강원도,1718,994,883,835,48.6
2021-06-07 00:00:00.000,경상남도,1614,881,838,776,48.08
2021-06-07 00:00:00.000,,1104,877,737,367,33.24
2021-06-07 00:00:00.000,충청북도,1410,804,721,689,48.87
2021-06-07 00:00:00.000,전라남도,1387,743,701,686,49.46
2021-06-07 00:00:00.000,전라북도,1287,714,661,626,48.64
2021-06-07 00:00:00.000,부산광역시,1306,703,645,661,50.61
2021-06-07 00:00:00.000,대전광역시,1054,584,536,518,49.15
2021-06-07 00:00:00.000,대구광역시,964,515,489,475,49.27
2021-06-07 00:00:00.000,경기,644,475,380,264,40.99
2021-06-07 00:00:00.000,광주광역시,817,430,404,413,50.55
2021-06-07 00:00:00.000,제주특별자치도,659,345,318,341,51.75
2021-06-07 00:00:00.000,울산광역시,477,267,248,229,48.01
2021-06-07 00:00:00.000,세종특별자치시,395,212,218,177,44.81
2021-06-07 00:00:00.000,인천광역,94,68,60,34,36.17
2021-06-07 00:00:00.000,충남,87,60,55,32,36.78
2021-06-07 00:00:00.000,인천,81,56,45,36,44.44
2021-06-07 00:00:00.000,경북,69,47,41,28,40.58
2021-06-07 00:00:00.000,강원,66,46,37,29,43.94
2021-06-07 00:00:00.000,충북,38,27,19,19,50
2021-06-07 00:00:00.000,전북,31,22,21,10,32.26
2021-06-07 00:00:00.000,부산,36,21,11,25,69.44
2021-06-07 00:00:00.000,경남,31,21,16,15,48.39
2021-06-07 00:00:00.000,대전,32,19,13,19,59.38
2021-06-07 00:00:00.000,★★★★★★★★,24,19,15,9,37.5
2021-06-07 00:00:00.000,대전광역,23,17,11,12,52.17
2021-06-07 00:00:00.000,제주도,25,16,9,16,64
2021-06-07 00:00:00.000,광주광역,20,16,10,10,50
2021-06-07 00:00:00.000,전남,20,15,14,6,30
2021-06-07 00:00:00.000,부산광역,20,14,11,9,45
2021-06-07 00:00:00.000,광주,26,13,14,12,46.15
2021-06-07 00:00:00.000,서울강북구,16,12,11,5,31.25
2021-06-07 00:00:00.000,울산,14,12,7,7,50
2021-06-07 00:00:00.000,대구,17,12,10,7,41.18
2021-06-07 00:00:00.000,대구광역,18,12,10,8,44.44
2021-06-07 00:00:00.000,제주,9,8,7,2,22.22
2021-06-07 00:00:00.000,울,6,5,4,2,33.33
2021-06-07 00:00:00.000,울산광역,8,4,3,5,62.5
2021-06-07 00:00:00.000,서울시,5,3,0,5,100
2021-06-07 00:00:00.000,기,4,3,4,0,0
2021-06-07 00:00:00.000,주,2,2,2,0,0
2021-06-07 00:00:00.000,천,2,2,2,0,0
2021-06-07 00:00:00.000,산,2,1,2,0,0
2021-06-07 00:00:00.000,남,1,1,1,0,0
2021-06-07 00:00:00.000,주공아파트,1,1,1,0,0
2021-06-07 00:00:00.000,인천직할시,3,1,0,3,100
2021-06-07 00:00:00.000,광주시,1,1,1,0,0
2021-06-07 00:00:00.000,서울관악구봉천1동,1,1,1,0,0
2021-06-07 00:00:00.000,강북구,2,1,1,1,50
2021-06-14 00:00:00.000,서울특별시,50551,31908,28239,22312,44.14
2021-06-14 00:00:00.000,경기도,18781,11523,10454,8327,44.34
2021-06-14 00:00:00.000,인천광역시,3152,1883,1749,1403,44.51
2021-06-14 00:00:00.000,서울,2248,1607,1356,892,39.68
2021-06-14 00:00:00.000,충청남도,2193,1347,1227,966,44.05
2021-06-14 00:00:00.000,경상북도,2048,1138,1093,955,46.63
2021-06-14 00:00:00.000,강원도,1637,989,940,697,42.58
2021-06-14 00:00:00.000,,1147,875,734,413,36.01
2021-06-14 00:00:00.000,경상남도,1604,828,795,809,50.44
2021-06-14 00:00:00.000,충청북도,1390,811,788,602,43.31
2021-06-14 00:00:00.000,전라북도,1296,712,708,588,45.37
2021-06-14 00:00:00.000,전라남도,1256,686,671,585,46.58
2021-06-14 00:00:00.000,부산광역시,1279,686,671,608,47.54
2021-06-14 00:00:00.000,대전광역시,1163,628,609,554,47.64
2021-06-14 00:00:00.000,경기,750,529,420,330,44
2021-06-14 00:00:00.000,대구광역시,954,497,493,461,48.32
2021-06-14 00:00:00.000,광주광역시,806,432,400,406,50.37
2021-06-14 00:00:00.000,제주특별자치도,702,372,368,334,47.58
2021-06-14 00:00:00.000,울산광역시,540,290,274,266,49.26
2021-06-14 00:00:00.000,세종특별자치시,388,230,219,169,43.56
2021-06-14 00:00:00.000,인천광역,150,93,65,85,56.67
2021-06-14 00:00:00.000,인천,100,69,66,34,34
2021-06-14 00:00:00.000,경북,81,51,46,35,43.21
2021-06-14 00:00:00.000,충남,80,48,47,33,41.25
2021-06-14 00:00:00.000,경남,53,31,28,25,47.17
2021-06-14 00:00:00.000,강원,41,30,21,20,48.78
2021-06-14 00:00:00.000,전남,40,26,21,19,47.5
2021-06-14 00:00:00.000,대구광역,42,25,23,19,45.24
2021-06-14 00:00:00.000,전북,39,25,20,19,48.72
2021-06-14 00:00:00.000,충북,32,25,17,15,46.88
2021-06-14 00:00:00.000,부산광역,38,21,18,20,52.63
2021-06-14 00:00:00.000,부산,36,21,19,17,47.22
2021-06-14 00:00:00.000,대전,31,21,15,16,51.61
2021-06-14 00:00:00.000,대구,24,17,9,15,62.5
2021-06-14 00:00:00.000,대전광역,25,17,12,13,52
2021-06-14 00:00:00.000,광주광역,20,15,11,9,45
2021-06-14 00:00:00.000,★★★★★★★★,27,15,10,17,62.96
2021-06-14 00:00:00.000,제주도,31,14,14,17,54.84
2021-06-14 00:00:00.000,서울강북구,18,13,11,7,38.89
2021-06-14 00:00:00.000,울산광역,14,9,7,7,50
2021-06-14 00:00:00.000,광주,9,8,8,1,11.11
2021-06-14 00:00:00.000,울산,18,8,10,8,44.44
2021-06-14 00:00:00.000,울,6,6,4,2,33.33
2021-06-14 00:00:00.000,제주,8,5,5,3,37.5
2021-06-14 00:00:00.000,기,6,2,3,3,50
2021-06-14 00:00:00.000,서울시,2,2,1,1,50
2021-06-14 00:00:00.000,인천직할시,1,1,1,0,0
2021-06-14 00:00:00.000,산,1,1,1,0,0
2021-06-14 00:00:00.000,주공아파트,1,1,1,0,0
2021-06-14 00:00:00.000,대동@,1,1,1,0,0
2021-06-14 00:00:00.000,광주시,2,1,1,1,50
2021-06-14 00:00:00.000,강북구,1,1,1,0,0
2021-06-14 00:00:00.000,북,1,1,1,0,0
2021-06-14 00:00:00.000,광주동구소태동,1,1,1,0,0
2021-06-14 00:00:00.000,남,2,1,1,1,50
2021-06-14 00:00:00.000,강서구,1,1,1,0,0
2021-06-21 00:00:00.000,서울특별시,50847,32120,28504,22343,43.94
2021-06-21 00:00:00.000,경기도,18774,11663,10624,8150,43.41
2021-06-21 00:00:00.000,인천광역시,3047,1797,1668,1379,45.26
2021-06-21 00:00:00.000,서울,2288,1590,1365,923,40.34
2021-06-21 00:00:00.000,충청남도,2256,1378,1280,976,43.26
2021-06-21 00:00:00.000,경상북도,2045,1164,1091,954,46.65
2021-06-21 00:00:00.000,강원도,1871,1107,1016,855,45.7
2021-06-21 00:00:00.000,경상남도,1719,923,844,875,50.9
2021-06-21 00:00:00.000,충청북도,1477,869,829,648,43.87
2021-06-21 00:00:00.000,,1103,867,741,362,32.82
2021-06-21 00:00:00.000,전라남도,1299,752,695,604,46.5
2021-06-21 00:00:00.000,부산광역시,1334,747,699,635,47.6
2021-06-21 00:00:00.000,전라북도,1305,729,737,568,43.52
2021-06-21 00:00:00.000,대전광역시,1157,658,658,499,43.13
2021-06-21 00:00:00.000,대구광역시,988,538,526,462,46.76
2021-06-21 00:00:00.000,경기,733,521,429,304,41.47
2021-06-21 00:00:00.000,광주광역시,782,428,401,381,48.72
2021-06-21 00:00:00.000,제주특별자치도,686,373,363,323,47.08
2021-06-21 00:00:00.000,울산광역시,584,293,296,288,49.32
2021-06-21 00:00:00.000,세종특별자치시,403,229,213,190,47.15
2021-06-21 00:00:00.000,인천광역,109,80,71,38,34.86
2021-06-21 00:00:00.000,경북,67,50,39,28,41.79
2021-06-21 00:00:00.000,인천,70,50,39,31,44.29
2021-06-21 00:00:00.000,충남,70,47,36,34,48.57
2021-06-21 00:00:00.000,경남,61,39,24,37,60.66
2021-06-21 00:00:00.000,충북,56,38,39,17,30.36
2021-06-21 00:00:00.000,전북,69,38,37,32,46.38
2021-06-21 00:00:00.000,강원,43,33,26,17,39.53
2021-06-21 00:00:00.000,전남,39,28,20,19,48.72
2021-06-21 00:00:00.000,광주광역,34,24,18,16,47.06
2021-06-21 00:00:00.000,부산광역,31,21,13,18,58.06
2021-06-21 00:00:00.000,대구광역,25,19,15,10,40
2021-06-21 00:00:00.000,대전,29,19,24,5,17.24
2021-06-21 00:00:00.000,대전광역,21,18,14,7,33.33
2021-06-21 00:00:00.000,대구,24,16,12,12,50
2021-06-21 00:00:00.000,광주,23,15,13,10,43.48
2021-06-21 00:00:00.000,제주도,20,15,12,8,40
2021-06-21 00:00:00.000,★★★★★★★★,16,14,12,4,25
2021-06-21 00:00:00.000,울산,22,13,9,13,59.09
2021-06-21 00:00:00.000,부산,16,11,6,10,62.5
2021-06-21 00:00:00.000,서울강북구,18,10,7,11,61.11
2021-06-21 00:00:00.000,울,9,8,8,1,11.11
2021-06-21 00:00:00.000,울산광역,11,8,7,4,36.36
2021-06-21 00:00:00.000,제주,11,7,8,3,27.27
2021-06-21 00:00:00.000,기,4,4,3,1,25
2021-06-21 00:00:00.000,서울시,2,1,1,1,50
2021-06-21 00:00:00.000,전,2,1,0,2,100
2021-06-21 00:00:00.000,북,3,1,0,3,100
2021-06-21 00:00:00.000,경기도화성시송산동,1,1,0,1,100
2021-06-21 00:00:00.000,산,1,1,0,1,100
2021-06-21 00:00:00.000,남,1,1,0,1,100
2021-06-28 00:00:00.000,서울특별시,49120,31162,27013,22107,45.01
2021-06-28 00:00:00.000,경기도,18326,11329,10051,8275,45.15
2021-06-28 00:00:00.000,인천광역시,3222,1889,1703,1519,47.14
2021-06-28 00:00:00.000,서울,2363,1646,1371,992,41.98
2021-06-28 00:00:00.000,충청남도,2163,1284,1165,998,46.14
2021-06-28 00:00:00.000,경상북도,2035,1155,1077,958,47.08
2021-06-28 00:00:00.000,강원도,1718,1001,897,821,47.79
2021-06-28 00:00:00.000,,1170,876,831,339,28.97
2021-06-28 00:00:00.000,경상남도,1498,835,789,709,47.33
2021-06-28 00:00:00.000,충청북도,1354,814,795,559,41.29
2021-06-28 00:00:00.000,전라남도,1376,731,689,687,49.93
2021-06-28 00:00:00.000,부산광역시,1308,725,645,663,50.69
2021-06-28 00:00:00.000,전라북도,1185,690,643,542,45.74
2021-06-28 00:00:00.000,대전광역시,1093,618,569,524,47.94
2021-06-28 00:00:00.000,대구광역시,950,544,501,449,47.26
2021-06-28 00:00:00.000,경기,708,492,390,318,44.92
2021-06-28 00:00:00.000,광주광역시,729,401,388,341,46.78
2021-06-28 00:00:00.000,제주특별자치도,736,380,369,367,49.86
2021-06-28 00:00:00.000,울산광역시,463,260,253,210,45.36
2021-06-28 00:00:00.000,세종특별자치시,330,210,183,147,44.55
2021-06-28 00:00:00.000,인천광역,106,72,56,50,47.17
2021-06-28 00:00:00.000,인천,99,63,48,51,51.52
2021-06-28 00:00:00.000,충남,86,53,38,48,55.81
2021-06-28 00:00:00.000,경남,80,51,49,31,38.75
2021-06-28 00:00:00.000,경북,60,43,33,27,45
2021-06-28 00:00:00.000,강원,65,42,29,36,55.38
2021-06-28 00:00:00.000,전남,39,28,17,22,56.41
2021-06-28 00:00:00.000,전북,44,27,21,23,52.27
2021-06-28 00:00:00.000,부산광역,50,27,20,30,60
2021-06-28 00:00:00.000,광주광역,33,27,24,9,27.27
2021-06-28 00:00:00.000,★★★★★★★★,29,23,12,17,58.62
2021-06-28 00:00:00.000,대전광역,36,22,16,20,55.56
2021-06-28 00:00:00.000,광주,36,20,24,12,33.33
2021-06-28 00:00:00.000,충북,30,19,10,20,66.67
2021-06-28 00:00:00.000,부산,29,18,15,14,48.28
2021-06-28 00:00:00.000,대전,24,16,10,14,58.33
2021-06-28 00:00:00.000,울산,21,12,10,11,52.38
2021-06-28 00:00:00.000,대구,22,11,11,11,50
2021-06-28 00:00:00.000,서울강북구,15,11,9,6,40
2021-06-28 00:00:00.000,울산광역,14,10,7,7,50
2021-06-28 00:00:00.000,대구광역,10,9,6,4,40
2021-06-28 00:00:00.000,제주도,19,9,10,9,47.37
2021-06-28 00:00:00.000,울,9,8,5,4,44.44
2021-06-28 00:00:00.000,제주,11,6,7,4,36.36
2021-06-28 00:00:00.000,기,6,3,3,3,50
2021-06-28 00:00:00.000,서울시,2,2,1,1,50
2021-06-28 00:00:00.000,산,3,2,3,0,0
2021-06-28 00:00:00.000,남,5,2,2,3,60
2021-06-28 00:00:00.000,북,3,1,1,2,66.67
2021-06-28 00:00:00.000,주,1,1,1,0,0
2021-06-28 00:00:00.000,전,1,1,1,0,0
2021-07-05 00:00:00.000,서울특별시,50325,31917,27733,22592,44.89
2021-07-05 00:00:00.000,경기도,18010,11185,9988,8022,44.54
2021-07-05 00:00:00.000,인천광역시,3235,1942,1775,1460,45.13
2021-07-05 00:00:00.000,서울,2347,1647,1286,1061,45.21
2021-07-05 00:00:00.000,충청남도,2206,1314,1221,985,44.65
2021-07-05 00:00:00.000,경상북도,2056,1165,1108,948,46.11
2021-07-05 00:00:00.000,강원도,1646,983,865,781,47.45
2021-07-05 00:00:00.000,,1212,940,793,419,34.57
2021-07-05 00:00:00.000,경상남도,1533,857,788,745,48.6
2021-07-05 00:00:00.000,충청북도,1365,805,728,637,46.67
2021-07-05 00:00:00.000,전라북도,1327,767,719,608,45.82
2021-07-05 00:00:00.000,전라남도,1315,712,707,608,46.24
2021-07-05 00:00:00.000,부산광역시,1272,701,633,639,50.24
2021-07-05 00:00:00.000,대전광역시,1155,650,611,544,47.1
2021-07-05 00:00:00.000,대구광역시,959,544,480,479,49.95
2021-07-05 00:00:00.000,경기,724,521,402,322,44.48
2021-07-05 00:00:00.000,광주광역시,828,467,432,396,47.83
2021-07-05 00:00:00.000,제주특별자치도,637,338,342,295,46.31
2021-07-05 00:00:00.000,울산광역시,568,307,282,286,50.35
2021-07-05 00:00:00.000,세종특별자치시,387,237,208,179,46.25
2021-07-05 00:00:00.000,인천,89,64,48,41,46.07
2021-07-05 00:00:00.000,인천광역,80,63,47,33,41.25
2021-07-05 00:00:00.000,충남,88,62,51,37,42.05
2021-07-05 00:00:00.000,경북,73,51,46,27,36.99
2021-07-05 00:00:00.000,강원,68,46,46,22,32.35
2021-07-05 00:00:00.000,경남,57,40,27,30,52.63
2021-07-05 00:00:00.000,★★★★★★★★,40,31,23,17,42.5
2021-07-05 00:00:00.000,전남,42,31,22,20,47.62
2021-07-05 00:00:00.000,충북,31,28,23,8,25.81
2021-07-05 00:00:00.000,부산,37,25,17,20,54.05
2021-07-05 00:00:00.000,부산광역,35,24,20,15,42.86
2021-07-05 00:00:00.000,전북,40,24,27,13,32.5
2021-07-05 00:00:00.000,광주광역,35,23,15,20,57.14
2021-07-05 00:00:00.000,대전광역,30,20,17,13,43.33
2021-07-05 00:00:00.000,대전,31,20,16,15,48.39
2021-07-05 00:00:00.000,광주,24,18,19,5,20.83
2021-07-05 00:00:00.000,대구,28,17,13,15,53.57
2021-07-05 00:00:00.000,대구광역,25,16,10,15,60
2021-07-05 00:00:00.000,서울강북구,18,14,15,3,16.67
2021-07-05 00:00:00.000,울산,19,12,10,9,47.37
2021-07-05 00:00:00.000,제주도,14,10,6,8,57.14
2021-07-05 00:00:00.000,울,11,10,7,4,36.36
2021-07-05 00:00:00.000,제주,15,8,6,9,60
2021-07-05 00:00:00.000,울산광역,9,7,6,3,33.33
2021-07-05 00:00:00.000,기,8,6,7,1,12.5
2021-07-05 00:00:00.000,서울시,3,3,2,1,33.33
2021-07-05 00:00:00.000,남,4,2,2,2,50
2021-07-05 00:00:00.000,경기용인시풍덕천2동,1,1,1,0,0
2021-07-05 00:00:00.000,서초구,1,1,0,1,100
2021-07-05 00:00:00.000,부산시,1,1,1,0,0
2021-07-05 00:00:00.000,천,1,1,1,0,0
2021-07-05 00:00:00.000,인천직할시,1,1,0,1,100
2021-07-05 00:00:00.000,전남여수시여서동,3,1,1,2,66.67
2021-07-12 00:00:00.000,서울특별시,51565,32422,28784,22781,44.18
2021-07-12 00:00:00.000,경기도,18900,11667,10574,8326,44.05
2021-07-12 00:00:00.000,인천광역시,3304,1943,1708,1596,48.31
2021-07-12 00:00:00.000,서울,2357,1680,1375,982,41.66
2021-07-12 00:00:00.000,충청남도,2262,1323,1243,1019,45.05
2021-07-12 00:00:00.000,경상북도,1923,1094,1027,896,46.59
2021-07-12 00:00:00.000,강원도,1738,1024,954,784,45.11
2021-07-12 00:00:00.000,,1166,904,798,368,31.56
2021-07-12 00:00:00.000,경상남도,1653,903,846,807,48.82
2021-07-12 00:00:00.000,충청북도,1469,842,796,673,45.81
2021-07-12 00:00:00.000,전라남도,1425,791,748,677,47.51
2021-07-12 00:00:00.000,전라북도,1221,706,658,563,46.11
2021-07-12 00:00:00.000,부산광역시,1297,701,680,617,47.57
2021-07-12 00:00:00.000,대전광역시,1202,650,616,586,48.75
2021-07-12 00:00:00.000,대구광역시,883,514,453,430,48.7
2021-07-12 00:00:00.000,경기,701,493,371,330,47.08
2021-07-12 00:00:00.000,광주광역시,783,427,387,396,50.57
2021-07-12 00:00:00.000,제주특별자치도,669,351,358,311,46.49
2021-07-12 00:00:00.000,울산광역시,463,255,245,218,47.08
2021-07-12 00:00:00.000,세종특별자치시,369,211,184,185,50.14
2021-07-12 00:00:00.000,인천광역,114,82,62,52,45.61
2021-07-12 00:00:00.000,충남,78,53,40,38,48.72
2021-07-12 00:00:00.000,인천,71,53,47,24,33.8
2021-07-12 00:00:00.000,경북,59,39,30,29,49.15
2021-07-12 00:00:00.000,강원,64,37,29,35,54.69
2021-07-12 00:00:00.000,전북,43,29,22,21,48.84
2021-07-12 00:00:00.000,경남,41,27,23,18,43.9
2021-07-12 00:00:00.000,광주광역,47,25,22,25,53.19
2021-07-12 00:00:00.000,전남,42,25,18,24,57.14
2021-07-12 00:00:00.000,부산광역,37,25,15,22,59.46
2021-07-12 00:00:00.000,부산,37,24,13,24,64.86
2021-07-12 00:00:00.000,충북,28,23,20,8,28.57
2021-07-12 00:00:00.000,★★★★★★★★,23,19,13,10,43.48
2021-07-12 00:00:00.000,대전,26,18,16,10,38.46
2021-07-12 00:00:00.000,대전광역,22,17,14,8,36.36
2021-07-12 00:00:00.000,광주,29,16,10,19,65.52
2021-07-12 00:00:00.000,대구광역,19,15,13,6,31.58
2021-07-12 00:00:00.000,대구,17,14,12,5,29.41
2021-07-12 00:00:00.000,울산,14,11,8,6,42.86
2021-07-12 00:00:00.000,울,11,9,7,4,36.36
2021-07-12 00:00:00.000,제주,16,8,10,6,37.5
2021-07-12 00:00:00.000,서울강북구,9,8,6,3,33.33
2021-07-12 00:00:00.000,제주도,11,7,7,4,36.36
2021-07-12 00:00:00.000,울산광역,5,4,2,3,60
2021-07-12 00:00:00.000,기,3,3,1,2,66.67
2021-07-12 00:00:00.000,서울시,3,3,1,2,66.67
2021-07-12 00:00:00.000,강북구,2,2,2,0,0
2021-07-12 00:00:00.000,주공아파트,1,1,1,0,0
2021-07-12 00:00:00.000,남,1,1,1,0,0
2021-07-12 00:00:00.000,전,2,1,0,2,100
2021-07-12 00:00:00.000,서대문구,1,1,1,0,0
2021-07-19 00:00:00.000,서울특별시,52766,32551,29239,23527,44.59
2021-07-19 00:00:00.000,경기도,18792,11644,10478,8314,44.24
2021-07-19 00:00:00.000,인천광역시,3206,1908,1709,1497,46.69
2021-07-19 00:00:00.000,서울,2412,1655,1379,1033,42.83
2021-07-19 00:00:00.000,충청남도,2234,1309,1259,975,43.64
2021-07-19 00:00:00.000,경상북도,1984,1139,1020,964,48.59
2021-07-19 00:00:00.000,강원도,1721,1031,943,778,45.21
2021-07-19 00:00:00.000,,1172,938,784,388,33.11
2021-07-19 00:00:00.000,경상남도,1646,888,780,866,52.61
2021-07-19 00:00:00.000,충청북도,1483,861,841,642,43.29
2021-07-19 00:00:00.000,전라남도,1282,729,682,600,46.8
2021-07-19 00:00:00.000,부산광역시,1417,717,707,710,50.11
2021-07-19 00:00:00.000,전라북도,1242,716,660,582,46.86
2021-07-19 00:00:00.000,대전광역시,1162,669,625,537,46.21
2021-07-19 00:00:00.000,경기,747,523,418,329,44.04
2021-07-19 00:00:00.000,대구광역시,930,506,493,437,46.99
2021-07-19 00:00:00.000,광주광역시,801,443,412,389,48.56
2021-07-19 00:00:00.000,제주특별자치도,716,386,397,319,44.55
2021-07-19 00:00:00.000,울산광역시,536,279,282,254,47.39
2021-07-19 00:00:00.000,세종특별자치시,412,245,220,192,46.6
2021-07-19 00:00:00.000,인천광역,128,90,78,50,39.06
2021-07-19 00:00:00.000,인천,85,54,42,43,50.59
2021-07-19 00:00:00.000,충남,75,52,42,33,44
2021-07-19 00:00:00.000,경북,56,47,36,20,35.71
2021-07-19 00:00:00.000,충북,70,42,32,38,54.29
2021-07-19 00:00:00.000,강원,63,41,34,29,46.03
2021-07-19 00:00:00.000,경남,53,31,19,34,64.15
2021-07-19 00:00:00.000,부산,43,27,22,21,48.84
2021-07-19 00:00:00.000,전북,39,26,25,14,35.9
2021-07-19 00:00:00.000,★★★★★★★★,32,25,17,15,46.88
2021-07-19 00:00:00.000,광주광역,29,24,17,12,41.38
2021-07-19 00:00:00.000,대전,36,22,13,23,63.89
2021-07-19 00:00:00.000,부산광역,32,21,16,16,50
2021-07-19 00:00:00.000,광주,34,21,18,16,47.06
2021-07-19 00:00:00.000,대전광역,19,17,16,3,15.79
2021-07-19 00:00:00.000,전남,25,17,15,10,40
2021-07-19 00:00:00.000,대구광역,18,14,11,7,38.89
2021-07-19 00:00:00.000,제주,27,14,13,14,51.85
2021-07-19 00:00:00.000,울산광역,13,10,8,5,38.46
2021-07-19 00:00:00.000,대구,18,9,8,10,55.56
2021-07-19 00:00:00.000,제주도,13,9,7,6,46.15
2021-07-19 00:00:00.000,서울강북구,10,7,7,3,30
2021-07-19 00:00:00.000,울,7,7,6,1,14.29
2021-07-19 00:00:00.000,울산,7,5,5,2,28.57
2021-07-19 00:00:00.000,남,5,3,3,2,40
2021-07-19 00:00:00.000,강북구,2,2,2,0,0
2021-07-19 00:00:00.000,서울시,2,2,1,1,50
2021-07-19 00:00:00.000,전,2,2,2,0,0
2021-07-19 00:00:00.000,광주시,2,1,1,1,50
2021-07-19 00:00:00.000,천,1,1,1,0,0
2021-07-19 00:00:00.000,서울관악구봉천1동,1,1,1,0,0
2021-07-19 00:00:00.000,전남여수시여서동,1,1,1,0,0
2021-07-19 00:00:00.000,북,3,1,1,2,66.67
2021-07-19 00:00:00.000,원,1,1,1,0,0
2021-07-19 00:00:00.000,기,1,1,1,0,0
2021-07-26 00:00:00.000,서울특별시,49920,31217,27592,22328,44.73
2021-07-26 00:00:00.000,경기도,18269,11263,10148,8121,44.45
2021-07-26 00:00:00.000,인천광역시,3170,1913,1718,1452,45.8
2021-07-26 00:00:00.000,서울,2212,1600,1297,915,41.37
2021-07-26 00:00:00.000,충청남도,2196,1323,1169,1027,46.77
2021-07-26 00:00:00.000,경상북도,1935,1112,1021,914,47.24
2021-07-26 00:00:00.000,강원도,1753,1032,931,822,46.89
2021-07-26 00:00:00.000,,1161,893,762,399,34.37
2021-07-26 00:00:00.000,경상남도,1621,890,832,789,48.67
2021-07-26 00:00:00.000,충청북도,1376,822,769,607,44.11
2021-07-26 00:00:00.000,전라북도,1305,748,675,630,48.28
2021-07-26 00:00:00.000,부산광역시,1360,697,671,689,50.66
2021-07-26 00:00:00.000,대전광역시,1215,691,612,603,49.63
2021-07-26 00:00:00.000,전라남도,1223,685,647,576,47.1
2021-07-26 00:00:00.000,대구광역시,866,517,448,418,48.27
2021-07-26 00:00:00.000,경기,778,516,381,397,51.03
2021-07-26 00:00:00.000,광주광역시,766,442,376,390,50.91
2021-07-26 00:00:00.000,제주특별자치도,631,346,336,295,46.75
2021-07-26 00:00:00.000,울산광역시,497,281,264,233,46.88
2021-07-26 00:00:00.000,세종특별자치시,392,229,228,164,41.84
2021-07-26 00:00:00.000,인천광역,134,91,69,65,48.51
2021-07-26 00:00:00.000,인천,107,75,60,47,43.93
2021-07-26 00:00:00.000,충남,82,57,46,36,43.9
2021-07-26 00:00:00.000,충북,61,43,28,33,54.1
2021-07-26 00:00:00.000,강원,44,33,24,20,45.45
2021-07-26 00:00:00.000,경남,46,31,23,23,50
2021-07-26 00:00:00.000,★★★★★★★★,35,30,21,14,40
2021-07-26 00:00:00.000,경북,51,30,25,26,50.98
2021-07-26 00:00:00.000,부산광역,42,29,17,25,59.52
2021-07-26 00:00:00.000,광주광역,48,26,20,28,58.33
2021-07-26 00:00:00.000,전남,33,23,16,17,51.52
2021-07-26 00:00:00.000,대전광역,33,23,16,17,51.52
2021-07-26 00:00:00.000,전북,24,19,13,11,45.83
2021-07-26 00:00:00.000,부산,28,19,14,14,50
2021-07-26 00:00:00.000,대구광역,28,19,16,12,42.86
2021-07-26 00:00:00.000,대전,22,16,12,10,45.45
2021-07-26 00:00:00.000,대구,24,14,14,10,41.67
2021-07-26 00:00:00.000,광주,17,12,5,12,70.59
2021-07-26 00:00:00.000,제주도,13,8,6,7,53.85
2021-07-26 00:00:00.000,서울강북구,12,7,3,9,75
2021-07-26 00:00:00.000,울산,8,6,4,4,50
2021-07-26 00:00:00.000,울,7,6,5,2,28.57
2021-07-26 00:00:00.000,제주,10,5,4,6,60
2021-07-26 00:00:00.000,기,6,4,2,4,66.67
2021-07-26 00:00:00.000,울산광역,4,3,4,0,0
2021-07-26 00:00:00.000,산,5,3,3,2,40
2021-07-26 00:00:00.000,서울시,3,3,0,3,100
2021-07-26 00:00:00.000,천,1,1,1,0,0
2021-07-26 00:00:00.000,원,2,1,0,2,100
2021-07-26 00:00:00.000,남동구만수2동,2,1,1,1,50
2021-07-26 00:00:00.000,강북구,2,1,1,1,50
2021-07-26 00:00:00.000,전,1,1,0,1,100
2021-07-26 00:00:00.000,경기용인시풍덕천2동,1,1,1,0,0
2021-07-26 00:00:00.000,남,1,1,1,0,0
2021-08-02 00:00:00.000,서울특별시,49396,30843,26970,22426,45.4
2021-08-02 00:00:00.000,경기도,18445,11391,10000,8445,45.78
2021-08-02 00:00:00.000,인천광역시,3111,1882,1667,1444,46.42
2021-08-02 00:00:00.000,서울,2236,1566,1271,965,43.16
2021-08-02 00:00:00.000,충청남도,2392,1431,1258,1134,47.41
2021-08-02 00:00:00.000,경상북도,1903,1062,981,922,48.45
2021-08-02 00:00:00.000,경상남도,1812,987,894,918,50.66
2021-08-02 00:00:00.000,강원도,1595,922,855,740,46.39
2021-08-02 00:00:00.000,충청북도,1454,859,803,651,44.77
2021-08-02 00:00:00.000,,1148,852,740,408,35.54
2021-08-02 00:00:00.000,전라북도,1400,776,699,701,50.07
2021-08-02 00:00:00.000,전라남도,1242,708,621,621,50
2021-08-02 00:00:00.000,대전광역시,1219,687,638,581,47.66
2021-08-02 00:00:00.000,부산광역시,1231,654,631,600,48.74
2021-08-02 00:00:00.000,대구광역시,927,540,447,480,51.78
2021-08-02 00:00:00.000,경기,723,513,394,329,45.5
2021-08-02 00:00:00.000,광주광역시,889,489,440,449,50.51
2021-08-02 00:00:00.000,제주특별자치도,602,320,305,297,49.34
2021-08-02 00:00:00.000,울산광역시,495,283,245,250,50.51
2021-08-02 00:00:00.000,세종특별자치시,351,208,186,165,47.01
2021-08-02 00:00:00.000,인천광역,142,104,80,62,43.66
2021-08-02 00:00:00.000,인천,94,67,50,44,46.81
2021-08-02 00:00:00.000,충남,108,65,51,57,52.78
2021-08-02 00:00:00.000,경북,71,47,34,37,52.11
2021-08-02 00:00:00.000,충북,71,42,33,38,53.52
2021-08-02 00:00:00.000,강원,45,33,29,16,35.56
2021-08-02 00:00:00.000,부산,35,28,17,18,51.43
2021-08-02 00:00:00.000,전북,33,27,16,17,51.52
2021-08-02 00:00:00.000,★★★★★★★★,29,26,15,14,48.28
2021-08-02 00:00:00.000,부산광역,40,26,17,23,57.5
2021-08-02 00:00:00.000,경남,36,26,15,21,58.33
2021-08-02 00:00:00.000,광주광역,31,25,18,13,41.94
2021-08-02 00:00:00.000,대전광역,23,17,12,11,47.83
2021-08-02 00:00:00.000,대구광역,22,16,10,12,54.55
2021-08-02 00:00:00.000,광주,25,16,9,16,64
2021-08-02 00:00:00.000,대전,23,14,9,14,60.87
2021-08-02 00:00:00.000,전남,21,13,10,11,52.38
2021-08-02 00:00:00.000,대구,13,11,10,3,23.08
2021-08-02 00:00:00.000,제주,19,11,13,6,31.58
2021-08-02 00:00:00.000,울산광역,19,11,9,10,52.63
2021-08-02 00:00:00.000,울산,17,10,8,9,52.94
2021-08-02 00:00:00.000,제주도,8,6,5,3,37.5
2021-08-02 00:00:00.000,서울시,8,5,3,5,62.5
2021-08-02 00:00:00.000,울,7,5,2,5,71.43
2021-08-02 00:00:00.000,서울강북구,7,5,3,4,57.14
2021-08-02 00:00:00.000,산,5,3,3,2,40
2021-08-02 00:00:00.000,강북구,3,2,1,2,66.67
2021-08-02 00:00:00.000,남,1,1,0,1,100
2021-08-02 00:00:00.000,남동구만수2동,1,1,1,0,0
2021-08-02 00:00:00.000,기,2,1,1,1,50
2021-08-02 00:00:00.000,북,1,1,1,0,0
2021-08-02 00:00:00.000,원,1,1,1,0,0
2021-08-09 00:00:00.000,서울특별시,51112,32258,28631,22481,43.98
2021-08-09 00:00:00.000,경기도,18647,11626,10463,8184,43.89
2021-08-09 00:00:00.000,인천광역시,3310,1995,1789,1521,45.95
2021-08-09 00:00:00.000,서울,2332,1657,1351,981,42.07
2021-08-09 00:00:00.000,충청남도,2398,1442,1351,1047,43.66
2021-08-09 00:00:00.000,경상북도,1972,1162,1067,905,45.89
2021-08-09 00:00:00.000,강원도,1742,1006,889,853,48.97
2021-08-09 00:00:00.000,경상남도,1728,940,886,842,48.73
2021-08-09 00:00:00.000,,1155,925,808,347,30.04
2021-08-09 00:00:00.000,충청북도,1442,829,792,650,45.08
2021-08-09 00:00:00.000,전라남도,1311,749,670,641,48.89
2021-08-09 00:00:00.000,전라북도,1326,745,701,625,47.13
2021-08-09 00:00:00.000,부산광역시,1297,723,652,645,49.73
2021-08-09 00:00:00.000,대전광역시,1173,657,640,533,45.44
2021-08-09 00:00:00.000,대구광역시,978,582,523,455,46.52
2021-08-09 00:00:00.000,경기,773,552,426,347,44.89
2021-08-09 00:00:00.000,광주광역시,866,502,465,401,46.3
2021-08-09 00:00:00.000,제주특별자치도,698,387,364,334,47.85
2021-08-09 00:00:00.000,울산광역시,525,282,269,256,48.76
2021-08-09 00:00:00.000,세종특별자치시,431,239,243,188,43.62
2021-08-09 00:00:00.000,인천광역,140,93,73,67,47.86
2021-08-09 00:00:00.000,인천,90,62,49,41,45.56
2021-08-09 00:00:00.000,경북,74,50,39,35,47.3
2021-08-09 00:00:00.000,충남,84,48,33,51,60.71
2021-08-09 00:00:00.000,강원,55,43,40,15,27.27
2021-08-09 00:00:00.000,충북,56,37,32,24,42.86
2021-08-09 00:00:00.000,경남,54,37,32,22,40.74
2021-08-09 00:00:00.000,전북,44,32,26,18,40.91
2021-08-09 00:00:00.000,광주광역,44,31,29,15,34.09
2021-08-09 00:00:00.000,대전광역,37,27,19,18,48.65
2021-08-09 00:00:00.000,부산광역,36,26,18,18,50
2021-08-09 00:00:00.000,부산,32,24,21,11,34.38
2021-08-09 00:00:00.000,전남,26,22,15,11,42.31
2021-08-09 00:00:00.000,대전,28,20,20,8,28.57
2021-08-09 00:00:00.000,★★★★★★★★,25,20,18,7,28
2021-08-09 00:00:00.000,대구,24,16,13,11,45.83
2021-08-09 00:00:00.000,광주,26,15,8,18,69.23
2021-08-09 00:00:00.000,대구광역,20,14,10,10,50
2021-08-09 00:00:00.000,울산,13,11,11,2,15.38
2021-08-09 00:00:00.000,제주도,19,11,9,10,52.63
2021-08-09 00:00:00.000,울산광역,10,9,5,5,50
2021-08-09 00:00:00.000,울,10,7,6,4,40
2021-08-09 00:00:00.000,기,9,6,5,4,44.44
2021-08-09 00:00:00.000,서울강북구,8,6,5,3,37.5
2021-08-09 00:00:00.000,서울시,10,5,5,5,50
2021-08-09 00:00:00.000,제주,7,2,5,2,28.57
2021-08-09 00:00:00.000,강북구,2,2,2,0,0
2021-08-09 00:00:00.000,남,3,2,1,2,66.67
2021-08-09 00:00:00.000,주,4,1,0,4,100
2021-08-09 00:00:00.000,원주시,2,1,0,2,100
2021-08-09 00:00:00.000,서울관악구봉천1동,1,1,1,0,0
2021-08-09 00:00:00.000,산,1,1,1,0,0
2021-08-09 00:00:00.000,충부,1,1,0,1,100
2021-08-16 00:00:00.000,서울특별시,49459,30890,27484,21975,44.43
2021-08-16 00:00:00.000,경기도,18106,11276,9963,8143,44.97
2021-08-16 00:00:00.000,인천광역시,3105,1871,1669,1436,46.25
2021-08-16 00:00:00.000,서울,2240,1575,1290,950,42.41
2021-08-16 00:00:00.000,충청남도,2228,1312,1218,1010,45.33
2021-08-16 00:00:00.000,경상북도,1963,1136,1055,908,46.26
2021-08-16 00:00:00.000,강원도,1708,1036,936,772,45.2
2021-08-16 00:00:00.000,,1257,968,720,537,42.72
2021-08-16 00:00:00.000,경상남도,1676,928,812,864,51.55
2021-08-16 00:00:00.000,충청북도,1364,815,745,619,45.38
2021-08-16 00:00:00.000,전라남도,1383,776,691,692,50.04
2021-08-16 00:00:00.000,부산광역시,1417,731,688,729,51.45
2021-08-16 00:00:00.000,전라북도,1246,704,648,598,47.99
2021-08-16 00:00:00.000,대전광역시,1203,697,657,546,45.39
2021-08-16 00:00:00.000,대구광역시,923,537,497,426,46.15
2021-08-16 00:00:00.000,경기,712,512,390,322,45.22
2021-08-16 00:00:00.000,광주광역시,809,452,417,392,48.45
2021-08-16 00:00:00.000,제주특별자치도,635,338,318,317,49.92
2021-08-16 00:00:00.000,울산광역시,532,290,286,246,46.24
2021-08-16 00:00:00.000,세종특별자치시,384,220,224,160,41.67
2021-08-16 00:00:00.000,인천광역,124,92,64,60,48.39
2021-08-16 00:00:00.000,인천,82,57,55,27,32.93
2021-08-16 00:00:00.000,충남,73,51,44,29,39.73
2021-08-16 00:00:00.000,충북,83,49,37,46,55.42
2021-08-16 00:00:00.000,경북,57,38,39,18,31.58
2021-08-16 00:00:00.000,강원,59,38,26,33,55.93
2021-08-16 00:00:00.000,경남,46,32,28,18,39.13
2021-08-16 00:00:00.000,★★★★★★★★,35,28,25,10,28.57
2021-08-16 00:00:00.000,광주광역,36,25,22,14,38.89
2021-08-16 00:00:00.000,부산광역,35,24,13,22,62.86
2021-08-16 00:00:00.000,광주,32,20,15,17,53.13
2021-08-16 00:00:00.000,전북,29,20,18,11,37.93
2021-08-16 00:00:00.000,전남,30,19,17,13,43.33
2021-08-16 00:00:00.000,대전광역,28,19,14,14,50
2021-08-16 00:00:00.000,부산,28,19,16,12,42.86
2021-08-16 00:00:00.000,대전,36,18,14,22,61.11
2021-08-16 00:00:00.000,대구광역,16,13,9,7,43.75
2021-08-16 00:00:00.000,제주도,17,11,10,7,41.18
2021-08-16 00:00:00.000,대구,13,11,11,2,15.38
2021-08-16 00:00:00.000,울,15,10,10,5,33.33
2021-08-16 00:00:00.000,제주,8,8,8,0,0
2021-08-16 00:00:00.000,울산,10,7,4,6,60
2021-08-16 00:00:00.000,서울강북구,5,5,3,2,40
2021-08-16 00:00:00.000,기,4,3,3,1,25
2021-08-16 00:00:00.000,울산광역,3,3,1,2,66.67
2021-08-16 00:00:00.000,서울시,3,2,0,3,100
2021-08-16 00:00:00.000,원,2,1,1,1,50
2021-08-16 00:00:00.000,주,1,1,1,0,0
2021-08-16 00:00:00.000,기도,1,1,1,0,0
2021-08-16 00:00:00.000,북,1,1,1,0,0
2021-08-16 00:00:00.000,산,3,1,0,3,100
2021-08-16 00:00:00.000,남,1,1,1,0,0
2021-08-23 00:00:00.000,서울특별시,50614,31488,27867,22747,44.94
2021-08-23 00:00:00.000,경기도,17940,11158,10084,7856,43.79
2021-08-23 00:00:00.000,인천광역시,3041,1780,1613,1428,46.96
2021-08-23 00:00:00.000,서울,2266,1597,1304,962,42.45
2021-08-23 00:00:00.000,충청남도,2200,1303,1231,969,44.05
2021-08-23 00:00:00.000,경상북도,2130,1166,1125,1005,47.18
2021-08-23 00:00:00.000,강원도,1706,1012,907,799,46.83
2021-08-23 00:00:00.000,경상남도,1686,932,876,810,48.04
2021-08-23 00:00:00.000,,1188,911,761,427,35.94
2021-08-23 00:00:00.000,충청북도,1402,804,750,652,46.5
2021-08-23 00:00:00.000,전라남도,1388,744,710,678,48.85
2021-08-23 00:00:00.000,부산광역시,1374,742,705,669,48.69
2021-08-23 00:00:00.000,전라북도,1226,701,617,609,49.67
2021-08-23 00:00:00.000,대전광역시,1196,686,632,564,47.16
2021-08-23 00:00:00.000,대구광역시,907,510,424,483,53.25
2021-08-23 00:00:00.000,경기,693,509,404,289,41.7
2021-08-23 00:00:00.000,광주광역시,777,440,409,368,47.36
2021-08-23 00:00:00.000,제주특별자치도,642,343,335,307,47.82
2021-08-23 00:00:00.000,울산광역시,477,271,260,217,45.49
2021-08-23 00:00:00.000,세종특별자치시,360,200,209,151,41.94
2021-08-23 00:00:00.000,인천광역,129,93,79,50,38.76
2021-08-23 00:00:00.000,인천,70,53,43,27,38.57
2021-08-23 00:00:00.000,충남,82,52,44,38,46.34
2021-08-23 00:00:00.000,경북,62,45,30,32,51.61
2021-08-23 00:00:00.000,경남,68,43,38,30,44.12
2021-08-23 00:00:00.000,강원,61,43,35,26,42.62
2021-08-23 00:00:00.000,충북,48,35,32,16,33.33
2021-08-23 00:00:00.000,전북,44,27,22,22,50
2021-08-23 00:00:00.000,대전,28,20,15,13,46.43
2021-08-23 00:00:00.000,부산광역,39,20,18,21,53.85
2021-08-23 00:00:00.000,부산,23,19,14,9,39.13
2021-08-23 00:00:00.000,★★★★★★★★,21,17,12,9,42.86
2021-08-23 00:00:00.000,광주,25,17,13,12,48
2021-08-23 00:00:00.000,전남,28,16,18,10,35.71
2021-08-23 00:00:00.000,대구,24,14,10,14,58.33
2021-08-23 00:00:00.000,대전광역,18,13,7,11,61.11
2021-08-23 00:00:00.000,대구광역,21,12,10,11,52.38
2021-08-23 00:00:00.000,광주광역,16,11,7,9,56.25
2021-08-23 00:00:00.000,제주도,18,10,8,10,55.56
2021-08-23 00:00:00.000,울산광역,12,8,7,5,41.67
2021-08-23 00:00:00.000,울산,14,8,5,9,64.29
2021-08-23 00:00:00.000,제주,12,6,6,6,50
2021-08-23 00:00:00.000,서울시,7,4,4,3,42.86
2021-08-23 00:00:00.000,서울강북구,6,4,3,3,50
2021-08-23 00:00:00.000,울,4,4,4,0,0
2021-08-23 00:00:00.000,산,4,2,4,0,0
2021-08-23 00:00:00.000,기,3,2,0,3,100
2021-08-23 00:00:00.000,원주시,2,1,0,2,100
2021-08-23 00:00:00.000,북,2,1,0,2,100
2021-08-23 00:00:00.000,남,1,1,1,0,0
2021-08-23 00:00:00.000,광주시,2,1,1,1,50
2021-08-30 00:00:00.000,서울특별시,50826,32000,28446,22380,44.03
2021-08-30 00:00:00.000,경기도,17660,11196,9830,7830,44.34
2021-08-30 00:00:00.000,인천광역시,3150,1867,1675,1475,46.83
2021-08-30 00:00:00.000,서울,2187,1572,1256,931,42.57
2021-08-30 00:00:00.000,충청남도,2101,1286,1235,866,41.22
2021-08-30 00:00:00.000,경상북도,1931,1091,974,957,49.56
2021-08-30 00:00:00.000,강원도,1598,984,867,731,45.74
2021-08-30 00:00:00.000,경상남도,1633,911,840,793,48.56
2021-08-30 00:00:00.000,,1082,845,707,375,34.66
2021-08-30 00:00:00.000,충청북도,1285,785,705,580,45.14
2021-08-30 00:00:00.000,부산광역시,1352,743,698,654,48.37
2021-08-30 00:00:00.000,전라북도,1241,731,644,597,48.11
2021-08-30 00:00:00.000,전라남도,1281,731,664,617,48.17
2021-08-30 00:00:00.000,대전광역시,1171,678,656,515,43.98
2021-08-30 00:00:00.000,대구광역시,943,560,479,464,49.2
2021-08-30 00:00:00.000,경기,683,497,396,287,42.02
2021-08-30 00:00:00.000,광주광역시,765,416,368,397,51.9
2021-08-30 00:00:00.000,제주특별자치도,638,374,333,305,47.81
2021-08-30 00:00:00.000,울산광역시,487,261,232,255,52.36
2021-08-30 00:00:00.000,세종특별자치시,355,215,202,153,43.1
2021-08-30 00:00:00.000,인천광역,120,91,72,48,40
2021-08-30 00:00:00.000,충남,78,52,38,40,51.28
2021-08-30 00:00:00.000,인천,64,52,39,25,39.06
2021-08-30 00:00:00.000,경북,55,38,31,24,43.64
2021-08-30 00:00:00.000,강원,46,35,25,21,45.65
2021-08-30 00:00:00.000,전북,37,31,23,14,37.84
2021-08-30 00:00:00.000,충북,46,31,28,18,39.13
2021-08-30 00:00:00.000,경남,39,27,21,18,46.15
2021-08-30 00:00:00.000,광주광역,33,22,19,14,42.42
2021-08-30 00:00:00.000,★★★★★★★★,23,21,16,7,30.43
2021-08-30 00:00:00.000,대전광역,28,20,13,15,53.57
2021-08-30 00:00:00.000,부산,28,19,15,13,46.43
2021-08-30 00:00:00.000,전남,25,17,19,6,24
2021-08-30 00:00:00.000,부산광역,22,15,7,15,68.18
2021-08-30 00:00:00.000,대구,23,14,9,14,60.87
2021-08-30 00:00:00.000,대전,23,13,14,9,39.13
2021-08-30 00:00:00.000,대구광역,14,13,9,5,35.71
2021-08-30 00:00:00.000,제주도,18,12,8,10,55.56
2021-08-30 00:00:00.000,광주,15,12,12,3,20
2021-08-30 00:00:00.000,울,13,10,9,4,30.77
2021-08-30 00:00:00.000,서울강북구,11,10,8,3,27.27
2021-08-30 00:00:00.000,울산,10,8,6,4,40
2021-08-30 00:00:00.000,제주,15,6,9,6,40
2021-08-30 00:00:00.000,남,7,4,3,4,57.14
2021-08-30 00:00:00.000,기,4,4,3,1,25
2021-08-30 00:00:00.000,북,2,2,2,0,0
2021-08-30 00:00:00.000,천,6,2,1,5,83.33
2021-08-30 00:00:00.000,울산광역,3,2,2,1,33.33
2021-08-30 00:00:00.000,서울시,3,2,1,2,66.67
2021-08-30 00:00:00.000,원주시,1,1,1,0,0
2021-08-30 00:00:00.000,주,1,1,1,0,0
2021-08-30 00:00:00.000,원,1,1,1,0,0
2021-08-30 00:00:00.000,경기도화성시송산동,1,1,0,1,100
2021-08-30 00:00:00.000,주공APT,1,1,1,0,0
2021-09-06 00:00:00.000,서울특별시,54485,33537,29503,24982,45.85
2021-09-06 00:00:00.000,경기도,19190,11659,10341,8849,46.11
2021-09-06 00:00:00.000,인천광역시,3223,1931,1719,1504,46.66
2021-09-06 00:00:00.000,서울,2425,1685,1332,1093,45.07
2021-09-06 00:00:00.000,충청남도,2387,1391,1296,1091,45.71
2021-09-06 00:00:00.000,경상북도,2096,1162,1085,1011,48.23
2021-09-06 00:00:00.000,강원도,1713,1021,944,769,44.89
2021-09-06 00:00:00.000,경상남도,1726,923,872,854,49.48
2021-09-06 00:00:00.000,,1135,894,744,391,34.45
2021-09-06 00:00:00.000,충청북도,1398,814,757,641,45.85
2021-09-06 00:00:00.000,전라남도,1434,740,740,694,48.4
2021-09-06 00:00:00.000,부산광역시,1407,729,725,682,48.47
2021-09-06 00:00:00.000,전라북도,1407,728,710,697,49.54
2021-09-06 00:00:00.000,대전광역시,1265,689,619,646,51.07
2021-09-06 00:00:00.000,대구광역시,959,543,497,462,48.18
2021-09-06 00:00:00.000,경기,790,534,444,346,43.8
2021-09-06 00:00:00.000,광주광역시,922,491,480,442,47.94
2021-09-06 00:00:00.000,제주특별자치도,701,374,343,358,51.07
2021-09-06 00:00:00.000,울산광역시,587,316,283,304,51.79
2021-09-06 00:00:00.000,세종특별자치시,443,240,240,203,45.82
2021-09-06 00:00:00.000,인천광역,116,94,69,47,40.52
2021-09-06 00:00:00.000,인천,78,54,40,38,48.72
2021-09-06 00:00:00.000,강원,70,49,36,34,48.57
2021-09-06 00:00:00.000,경남,75,45,39,36,48
2021-09-06 00:00:00.000,충남,70,44,31,39,55.71
2021-09-06 00:00:00.000,경북,52,33,28,24,46.15
2021-09-06 00:00:00.000,전북,48,30,24,24,50
2021-09-06 00:00:00.000,충북,40,29,24,16,40
2021-09-06 00:00:00.000,부산광역,31,25,18,13,41.94
2021-09-06 00:00:00.000,부산,29,19,15,14,48.28
2021-09-06 00:00:00.000,대전광역,28,19,11,17,60.71
2021-09-06 00:00:00.000,대구,32,19,19,13,40.63
2021-09-06 00:00:00.000,전남,37,19,20,17,45.95
2021-09-06 00:00:00.000,대전,30,18,13,17,56.67
2021-09-06 00:00:00.000,★★★★★★★★,20,17,11,9,45
2021-09-06 00:00:00.000,광주광역,21,17,14,7,33.33
2021-09-06 00:00:00.000,대구광역,20,16,14,6,30
2021-09-06 00:00:00.000,광주,14,11,10,4,28.57
2021-09-06 00:00:00.000,제주도,14,11,11,3,21.43
2021-09-06 00:00:00.000,울산,9,8,7,2,22.22
2021-09-06 00:00:00.000,울,9,7,9,0,0
2021-09-06 00:00:00.000,울산광역,6,5,5,1,16.67
2021-09-06 00:00:00.000,서울강북구,6,4,3,3,50
2021-09-06 00:00:00.000,제주,11,4,4,7,63.64
2021-09-06 00:00:00.000,남,7,4,4,3,42.86
2021-09-06 00:00:00.000,서울시,4,3,3,1,25
2021-09-06 00:00:00.000,기,5,3,1,4,80
2021-09-06 00:00:00.000,천,3,2,3,0,0
2021-09-06 00:00:00.000,북,1,1,1,0,0
2021-09-06 00:00:00.000,주,2,1,0,2,100
2021-09-06 00:00:00.000,전,4,1,2,2,50
2021-09-06 00:00:00.000,서대문구,1,1,1,0,0
2021-09-06 00:00:00.000,서울관악구봉천1동,1,1,1,0,0
2021-09-13 00:00:00.000,서울특별시,55692,34213,31837,23855,42.83
2021-09-13 00:00:00.000,경기도,19838,12175,11104,8734,44.03
2021-09-13 00:00:00.000,인천광역시,3533,2074,2024,1509,42.71
2021-09-13 00:00:00.000,서울,2497,1769,1502,995,39.85
2021-09-13 00:00:00.000,충청남도,2318,1376,1279,1039,44.82
2021-09-13 00:00:00.000,경상북도,2190,1181,1129,1061,48.45
2021-09-13 00:00:00.000,강원도,1856,1102,995,861,46.39
2021-09-13 00:00:00.000,,1266,1017,767,499,39.42
2021-09-13 00:00:00.000,경상남도,1827,953,947,880,48.17
2021-09-13 00:00:00.000,충청북도,1406,839,820,586,41.68
2021-09-13 00:00:00.000,부산광역시,1481,752,770,711,48.01
2021-09-13 00:00:00.000,전라남도,1380,741,753,627,45.43
2021-09-13 00:00:00.000,대전광역시,1218,694,687,531,43.6
2021-09-13 00:00:00.000,전라북도,1252,693,674,578,46.17
2021-09-13 00:00:00.000,대구광역시,952,532,537,415,43.59
2021-09-13 00:00:00.000,경기,747,520,458,289,38.69
2021-09-13 00:00:00.000,광주광역시,866,456,440,426,49.19
2021-09-13 00:00:00.000,제주특별자치도,669,354,322,347,51.87
2021-09-13 00:00:00.000,울산광역시,517,281,296,221,42.75
2021-09-13 00:00:00.000,세종특별자치시,431,234,237,194,45.01
2021-09-13 00:00:00.000,인천광역,135,99,87,48,35.56
2021-09-13 00:00:00.000,인천,91,60,52,39,42.86
2021-09-13 00:00:00.000,충남,76,49,46,30,39.47
2021-09-13 00:00:00.000,경북,65,47,41,24,36.92
2021-09-13 00:00:00.000,강원,54,43,30,24,44.44
2021-09-13 00:00:00.000,경남,59,38,37,22,37.29
2021-09-13 00:00:00.000,전북,51,29,33,18,35.29
2021-09-13 00:00:00.000,충북,36,25,23,13,36.11
2021-09-13 00:00:00.000,대전,33,23,21,12,36.36
2021-09-13 00:00:00.000,★★★★★★★★,29,21,19,10,34.48
2021-09-13 00:00:00.000,대전광역,35,21,12,23,65.71
2021-09-13 00:00:00.000,광주광역,24,18,14,10,41.67
2021-09-13 00:00:00.000,대구광역,26,16,13,13,50
2021-09-13 00:00:00.000,부산,23,15,9,14,60.87
2021-09-13 00:00:00.000,광주,27,14,13,14,51.85
2021-09-13 00:00:00.000,전남,28,14,19,9,32.14
2021-09-13 00:00:00.000,부산광역,23,13,15,8,34.78
2021-09-13 00:00:00.000,대구,13,10,10,3,23.08
2021-09-13 00:00:00.000,서울강북구,12,10,8,4,33.33
2021-09-13 00:00:00.000,제주,19,9,8,11,57.89
2021-09-13 00:00:00.000,울,9,8,5,4,44.44
2021-09-13 00:00:00.000,울산,7,6,6,1,14.29
2021-09-13 00:00:00.000,울산광역,7,5,4,3,42.86
2021-09-13 00:00:00.000,제주도,10,5,5,5,50
2021-09-13 00:00:00.000,북,8,4,2,6,75
2021-09-13 00:00:00.000,기,3,3,2,1,33.33
2021-09-13 00:00:00.000,서울시,7,3,1,6,85.71
2021-09-13 00:00:00.000,경기도화성시송산동,2,2,2,0,0
2021-09-13 00:00:00.000,원,2,2,1,1,50
2021-09-13 00:00:00.000,산,2,2,2,0,0
2021-09-13 00:00:00.000,주,1,1,1,0,0
2021-09-13 00:00:00.000,경기의왕시포일동,2,1,1,1,50
2021-09-13 00:00:00.000,서울강북구번3동,1,1,1,0,0
2021-09-20 00:00:00.000,서울특별시,24556,16220,12247,12309,50.13
2021-09-20 00:00:00.000,경기도,8590,5663,4362,4228,49.22
2021-09-20 00:00:00.000,인천광역시,1472,901,711,761,51.7
2021-09-20 00:00:00.000,서울,1045,766,549,496,47.46
2021-09-20 00:00:00.000,충청남도,900,564,438,462,51.33
2021-09-20 00:00:00.000,경상북도,785,494,371,414,52.74
2021-09-20 00:00:00.000,강원도,775,480,382,393,50.71
2021-09-20 00:00:00.000,경상남도,735,408,335,400,54.42
2021-09-20 00:00:00.000,충청북도,635,401,304,331,52.13
2021-09-20 00:00:00.000,부산광역시,573,330,270,303,52.88
2021-09-20 00:00:00.000,,429,327,248,181,42.19
2021-09-20 00:00:00.000,전라북도,555,323,226,329,59.28
2021-09-20 00:00:00.000,전라남도,558,301,239,319,57.17
2021-09-20 00:00:00.000,대전광역시,497,287,234,263,52.92
2021-09-20 00:00:00.000,대구광역시,350,221,160,190,54.29
2021-09-20 00:00:00.000,경기,288,208,160,128,44.44
2021-09-20 00:00:00.000,광주광역시,357,207,148,209,58.54
2021-09-20 00:00:00.000,제주특별자치도,253,140,135,118,46.64
2021-09-20 00:00:00.000,울산광역시,204,106,96,108,52.94
2021-09-20 00:00:00.000,세종특별자치시,166,103,90,76,45.78
2021-09-20 00:00:00.000,인천광역,44,33,18,26,59.09
2021-09-20 00:00:00.000,인천,27,17,16,11,40.74
2021-09-20 00:00:00.000,충남,27,16,10,17,62.96
2021-09-20 00:00:00.000,경북,25,16,11,14,56
2021-09-20 00:00:00.000,강원,23,16,12,11,47.83
2021-09-20 00:00:00.000,경남,21,14,9,12,57.14
2021-09-20 00:00:00.000,전북,19,11,7,12,63.16
2021-09-20 00:00:00.000,광주광역,13,8,4,9,69.23
2021-09-20 00:00:00.000,부산,10,8,8,2,20
2021-09-20 00:00:00.000,광주,8,7,7,1,12.5
2021-09-20 00:00:00.000,대전광역,10,7,8,2,20
2021-09-20 00:00:00.000,전남,9,6,4,5,55.56
2021-09-20 00:00:00.000,부산광역,9,6,2,7,77.78
2021-09-20 00:00:00.000,대구광역,7,6,6,1,14.29
2021-09-20 00:00:00.000,울산,10,5,6,4,40
2021-09-20 00:00:00.000,★★★★★★★★,5,5,3,2,40
2021-09-20 00:00:00.000,충북,7,5,5,2,28.57
2021-09-20 00:00:00.000,대전,6,5,4,2,33.33
2021-09-20 00:00:00.000,대구,8,5,4,4,50
2021-09-20 00:00:00.000,서울강북구,5,4,2,3,60
2021-09-20 00:00:00.000,울,5,4,2,3,60
2021-09-20 00:00:00.000,울산광역,5,3,2,3,60
2021-09-20 00:00:00.000,제주도,11,3,6,5,45.45
2021-09-20 00:00:00.000,제주,3,2,2,1,33.33
2021-09-20 00:00:00.000,남,1,1,0,1,100
2021-09-20 00:00:00.000,서울강북구번3동,2,1,1,1,50
2021-09-20 00:00:00.000,북,1,1,1,0,0
2021-09-20 00:00:00.000,기,1,1,1,0,0
2021-09-20 00:00:00.000,서울시,2,1,1,1,50
2021-09-27 00:00:00.000,서울특별시,56642,35389,31942,24700,43.61
2021-09-27 00:00:00.000,경기도,20322,12440,11326,8996,44.27
2021-09-27 00:00:00.000,인천광역시,3535,2105,1955,1580,44.7
2021-09-27 00:00:00.000,서울,2504,1737,1490,1014,40.5
2021-09-27 00:00:00.000,충청남도,2411,1434,1394,1017,42.18
2021-09-27 00:00:00.000,경상북도,2325,1306,1244,1081,46.49
2021-09-27 00:00:00.000,강원도,2021,1176,1090,931,46.07
2021-09-27 00:00:00.000,경상남도,1859,984,947,912,49.06
2021-09-27 00:00:00.000,충청북도,1568,882,867,701,44.71
2021-09-27 00:00:00.000,전라북도,1465,826,811,654,44.64
2021-09-27 00:00:00.000,부산광역시,1531,824,807,724,47.29
2021-09-27 00:00:00.000,전라남도,1515,819,780,735,48.51
2021-09-27 00:00:00.000,,1049,809,658,391,37.27
2021-09-27 00:00:00.000,대전광역시,1296,722,702,594,45.83
2021-09-27 00:00:00.000,대구광역시,1056,579,554,502,47.54
2021-09-27 00:00:00.000,경기,767,543,445,322,41.98
2021-09-27 00:00:00.000,광주광역시,1007,516,499,508,50.45
2021-09-27 00:00:00.000,제주특별자치도,777,397,416,361,46.46
2021-09-27 00:00:00.000,울산광역시,572,316,310,262,45.8
2021-09-27 00:00:00.000,세종특별자치시,413,240,209,204,49.39
2021-09-27 00:00:00.000,인천광역,128,87,65,63,49.22
2021-09-27 00:00:00.000,인천,99,67,59,40,40.4
2021-09-27 00:00:00.000,충남,92,59,48,44,47.83
2021-09-27 00:00:00.000,강원,64,47,41,23,35.94
2021-09-27 00:00:00.000,충북,54,41,28,26,48.15
2021-09-27 00:00:00.000,경북,58,39,28,30,51.72
2021-09-27 00:00:00.000,경남,63,38,30,33,52.38
2021-09-27 00:00:00.000,★★★★★★★★,31,25,20,11,35.48
2021-09-27 00:00:00.000,광주광역,34,25,18,16,47.06
2021-09-27 00:00:00.000,부산광역,33,24,16,17,51.52
2021-09-27 00:00:00.000,대전,34,24,18,16,47.06
2021-09-27 00:00:00.000,부산,36,21,16,20,55.56
2021-09-27 00:00:00.000,전북,31,21,20,11,35.48
2021-09-27 00:00:00.000,광주,29,19,17,12,41.38
2021-09-27 00:00:00.000,대전광역,26,18,12,14,53.85
2021-09-27 00:00:00.000,전남,27,15,20,7,25.93
2021-09-27 00:00:00.000,대구,20,14,10,10,50
2021-09-27 00:00:00.000,대구광역,17,13,9,8,47.06
2021-09-27 00:00:00.000,제주,16,11,8,8,50
2021-09-27 00:00:00.000,울산광역,11,10,11,0,0
2021-09-27 00:00:00.000,제주도,13,9,10,3,23.08
2021-09-27 00:00:00.000,서울강북구,8,7,6,2,25
2021-09-27 00:00:00.000,울산,12,7,6,6,50
2021-09-27 00:00:00.000,울,9,6,9,0,0
2021-09-27 00:00:00.000,서울시,7,4,2,5,71.43
2021-09-27 00:00:00.000,남,8,3,4,4,50
2021-09-27 00:00:00.000,산,3,2,3,0,0
2021-09-27 00:00:00.000,원,3,1,2,1,33.33
2021-09-27 00:00:00.000,북,1,1,1,0,0
2021-09-27 00:00:00.000,기,1,1,1,0,0
2021-09-27 00:00:00.000,경기용인시풍덕천2동,1,1,1,0,0
2021-09-27 00:00:00.000,광주시,2,1,1,1,50
2021-10-04 00:00:00.000,서울특별시,46535,29415,24831,21704,46.64
2021-10-04 00:00:00.000,경기도,16393,10217,8756,7637,46.59
2021-10-04 00:00:00.000,인천광역시,2783,1685,1437,1346,48.37
2021-10-04 00:00:00.000,서울,2214,1543,1184,1030,46.52
2021-10-04 00:00:00.000,충청남도,2007,1174,1008,999,49.78
2021-10-04 00:00:00.000,경상북도,1866,1078,948,918,49.2
2021-10-04 00:00:00.000,강원도,1611,971,809,802,49.78
2021-10-04 00:00:00.000,경상남도,1578,881,772,806,51.08
2021-10-04 00:00:00.000,,992,778,622,370,37.3
2021-10-04 00:00:00.000,충청북도,1280,748,637,643,50.23
2021-10-04 00:00:00.000,부산광역시,1318,725,621,697,52.88
2021-10-04 00:00:00.000,전라남도,1249,696,622,627,50.2
2021-10-04 00:00:00.000,전라북도,1224,673,609,615,50.25
2021-10-04 00:00:00.000,대전광역시,1077,583,527,550,51.07
2021-10-04 00:00:00.000,대구광역시,826,464,401,425,51.45
2021-10-04 00:00:00.000,경기,667,464,334,333,49.93
2021-10-04 00:00:00.000,광주광역시,727,425,384,343,47.18
2021-10-04 00:00:00.000,제주특별자치도,594,336,304,290,48.82
2021-10-04 00:00:00.000,울산광역시,490,255,249,241,49.18
2021-10-04 00:00:00.000,세종특별자치시,335,203,179,156,46.57
2021-10-04 00:00:00.000,인천광역,120,90,66,54,45
2021-10-04 00:00:00.000,인천,85,59,56,29,34.12
2021-10-04 00:00:00.000,경북,65,47,36,29,44.62
2021-10-04 00:00:00.000,충남,51,37,30,21,41.18
2021-10-04 00:00:00.000,강원,55,36,24,31,56.36
2021-10-04 00:00:00.000,경남,59,36,24,35,59.32
2021-10-04 00:00:00.000,부산광역,54,30,25,29,53.7
2021-10-04 00:00:00.000,대전,44,28,18,26,59.09
2021-10-04 00:00:00.000,충북,38,27,18,20,52.63
2021-10-04 00:00:00.000,전남,40,24,16,24,60
2021-10-04 00:00:00.000,전북,37,23,18,19,51.35
2021-10-04 00:00:00.000,★★★★★★★★,30,21,17,13,43.33
2021-10-04 00:00:00.000,광주광역,26,19,19,7,26.92
2021-10-04 00:00:00.000,대전광역,24,17,14,10,41.67
2021-10-04 00:00:00.000,대구광역,27,17,12,15,55.56
2021-10-04 00:00:00.000,광주,26,14,9,17,65.38
2021-10-04 00:00:00.000,부산,20,13,10,10,50
2021-10-04 00:00:00.000,대구,13,10,7,6,46.15
2021-10-04 00:00:00.000,제주,18,9,11,7,38.89
2021-10-04 00:00:00.000,서울강북구,10,8,7,3,30
2021-10-04 00:00:00.000,울산광역,12,8,7,5,41.67
2021-10-04 00:00:00.000,울산,8,6,5,3,37.5
2021-10-04 00:00:00.000,제주도,11,6,4,7,63.64
2021-10-04 00:00:00.000,울,6,5,5,1,16.67
2021-10-04 00:00:00.000,서울시,3,3,2,1,33.33
2021-10-04 00:00:00.000,주,3,3,3,0,0
2021-10-04 00:00:00.000,기,2,2,1,1,50
2021-10-04 00:00:00.000,남,3,1,0,3,100
2021-10-04 00:00:00.000,전,1,1,1,0,0
2021-10-04 00:00:00.000,산,2,1,2,0,0
2021-10-11 00:00:00.000,서울특별시,45400,29259,25085,20315,44.75
2021-10-11 00:00:00.000,경기도,16127,10309,8784,7343,45.53
2021-10-11 00:00:00.000,인천광역시,2835,1761,1572,1263,44.55
2021-10-11 00:00:00.000,서울,2028,1508,1185,843,41.57
2021-10-11 00:00:00.000,충청남도,1989,1231,1131,858,43.14
2021-10-11 00:00:00.000,경상북도,1871,1097,1009,862,46.07
2021-10-11 00:00:00.000,강원도,1473,930,794,679,46.1
2021-10-11 00:00:00.000,경상남도,1579,848,803,776,49.15
2021-10-11 00:00:00.000,,1022,802,660,362,35.42
2021-10-11 00:00:00.000,충청북도,1320,781,732,588,44.55
2021-10-11 00:00:00.000,전라남도,1269,694,636,633,49.88
2021-10-11 00:00:00.000,부산광역시,1251,684,646,605,48.36
2021-10-11 00:00:00.000,전라북도,1116,659,610,506,45.34
2021-10-11 00:00:00.000,대전광역시,1033,572,505,528,51.11
2021-10-11 00:00:00.000,대구광역시,874,504,463,411,47.03
2021-10-11 00:00:00.000,경기,633,466,365,268,42.34
2021-10-11 00:00:00.000,광주광역시,723,417,369,354,48.96
2021-10-11 00:00:00.000,제주특별자치도,600,339,317,283,47.17
2021-10-11 00:00:00.000,울산광역시,531,271,255,276,51.98
2021-10-11 00:00:00.000,세종특별자치시,335,204,174,161,48.06
2021-10-11 00:00:00.000,인천광역,121,82,59,62,51.24
2021-10-11 00:00:00.000,인천,79,54,40,39,49.37
2021-10-11 00:00:00.000,충남,72,50,35,37,51.39
2021-10-11 00:00:00.000,경북,71,47,38,33,46.48
2021-10-11 00:00:00.000,강원,60,41,33,27,45
2021-10-11 00:00:00.000,충북,53,35,24,29,54.72
2021-10-11 00:00:00.000,★★★★★★★★,35,29,20,15,42.86
2021-10-11 00:00:00.000,전남,46,28,15,31,67.39
2021-10-11 00:00:00.000,경남,36,25,18,18,50
2021-10-11 00:00:00.000,전북,38,22,17,21,55.26
2021-10-11 00:00:00.000,부산광역,26,21,15,11,42.31
2021-10-11 00:00:00.000,광주광역,31,21,14,17,54.84
2021-10-11 00:00:00.000,대전광역,30,21,15,15,50
2021-10-11 00:00:00.000,부산,33,19,5,28,84.85
2021-10-11 00:00:00.000,대구,29,19,15,14,48.28
2021-10-11 00:00:00.000,대구광역,28,16,13,15,53.57
2021-10-11 00:00:00.000,광주,22,15,12,10,45.45
2021-10-11 00:00:00.000,대전,21,14,14,7,33.33
2021-10-11 00:00:00.000,울산,21,12,10,11,52.38
2021-10-11 00:00:00.000,서울강북구,9,8,7,2,22.22
2021-10-11 00:00:00.000,제주도,8,8,7,1,12.5
2021-10-11 00:00:00.000,제주,14,7,9,5,35.71
2021-10-11 00:00:00.000,울,9,6,3,6,66.67
2021-10-11 00:00:00.000,서울시,9,6,6,3,33.33
2021-10-11 00:00:00.000,기,5,4,4,1,20
2021-10-11 00:00:00.000,울산광역,5,4,3,2,40
2021-10-11 00:00:00.000,원,2,2,2,0,0
2021-10-11 00:00:00.000,남,4,2,0,4,100
2021-10-11 00:00:00.000,산,1,1,1,0,0
2021-10-11 00:00:00.000,전,2,1,0,2,100
2021-10-11 00:00:00.000,북,2,1,1,1,50
2021-10-18 00:00:00.000,서울특별시,52295,32686,28452,23843,45.59
2021-10-18 00:00:00.000,경기도,19236,11790,10409,8827,45.89
2021-10-18 00:00:00.000,인천광역시,3197,1950,1710,1487,46.51
2021-10-18 00:00:00.000,서울,2521,1750,1451,1070,42.44
2021-10-18 00:00:00.000,충청남도,2338,1374,1314,1024,43.8
2021-10-18 00:00:00.000,경상북도,2069,1191,1083,986,47.66
2021-10-18 00:00:00.000,강원도,1734,1053,907,827,47.69
2021-10-18 00:00:00.000,,1268,1013,864,404,31.86
2021-10-18 00:00:00.000,경상남도,1870,994,930,940,50.27
2021-10-18 00:00:00.000,충청북도,1556,889,857,699,44.92
2021-10-18 00:00:00.000,부산광역시,1498,806,769,729,48.66
2021-10-18 00:00:00.000,전라북도,1369,758,698,671,49.01
2021-10-18 00:00:00.000,전라남도,1372,751,703,669,48.76
2021-10-18 00:00:00.000,대전광역시,1216,686,630,586,48.19
2021-10-18 00:00:00.000,대구광역시,1027,580,523,504,49.07
2021-10-18 00:00:00.000,경기,744,517,402,342,45.97
2021-10-18 00:00:00.000,광주광역시,958,506,531,427,44.57
2021-10-18 00:00:00.000,제주특별자치도,767,411,390,377,49.15
2021-10-18 00:00:00.000,울산광역시,605,322,301,304,50.25
2021-10-18 00:00:00.000,세종특별자치시,383,215,192,191,49.87
2021-10-18 00:00:00.000,인천광역,131,88,71,60,45.8
2021-10-18 00:00:00.000,충남,86,63,50,36,41.86
2021-10-18 00:00:00.000,인천,91,62,47,44,48.35
2021-10-18 00:00:00.000,경북,86,53,42,44,51.16
2021-10-18 00:00:00.000,강원,63,43,30,33,52.38
2021-10-18 00:00:00.000,경남,72,43,35,37,51.39
2021-10-18 00:00:00.000,충북,69,41,36,33,47.83
2021-10-18 00:00:00.000,★★★★★★★★,51,34,20,31,60.78
2021-10-18 00:00:00.000,전북,50,31,24,26,52
2021-10-18 00:00:00.000,전남,45,29,26,19,42.22
2021-10-18 00:00:00.000,대전광역,52,28,13,39,75
2021-10-18 00:00:00.000,부산광역,38,23,18,20,52.63
2021-10-18 00:00:00.000,대전,34,20,15,19,55.88
2021-10-18 00:00:00.000,부산,25,19,16,9,36
2021-10-18 00:00:00.000,광주광역,35,19,19,16,45.71
2021-10-18 00:00:00.000,광주,24,15,14,10,41.67
2021-10-18 00:00:00.000,대구광역,19,15,12,7,36.84
2021-10-18 00:00:00.000,울산,25,15,10,15,60
2021-10-18 00:00:00.000,대구,15,11,9,6,40
2021-10-18 00:00:00.000,울산광역,10,7,5,5,50
2021-10-18 00:00:00.000,제주,11,7,5,6,54.55
2021-10-18 00:00:00.000,울,9,6,3,6,66.67
2021-10-18 00:00:00.000,서울강북구,7,6,5,2,28.57
2021-10-18 00:00:00.000,기,8,5,2,6,75
2021-10-18 00:00:00.000,남,5,4,3,2,40
2021-10-18 00:00:00.000,제주도,4,4,3,1,25
2021-10-18 00:00:00.000,산,4,3,2,2,50
2021-10-18 00:00:00.000,서울시,3,2,0,3,100
2021-10-18 00:00:00.000,북,2,2,2,0,0
2021-10-18 00:00:00.000,세종시,1,1,1,0,0
2021-10-18 00:00:00.000,천,1,1,1,0,0
2021-10-18 00:00:00.000,강동구,1,1,1,0,0
2021-10-18 00:00:00.000,전,1,1,1,0,0
2021-10-18 00:00:00.000,강북구,1,1,1,0,0
2021-10-25 00:00:00.000,서울특별시,53997,33603,29581,24416,45.22
2021-10-25 00:00:00.000,경기도,19448,11940,10575,8873,45.62
2021-10-25 00:00:00.000,인천광역시,3353,1982,1841,1512,45.09
2021-10-25 00:00:00.000,서울,2495,1759,1369,1126,45.13
2021-10-25 00:00:00.000,충청남도,2341,1366,1264,1077,46.01
2021-10-25 00:00:00.000,,1546,1282,642,904,58.47
2021-10-25 00:00:00.000,경상북도,2192,1237,1142,1050,47.9
2021-10-25 00:00:00.000,강원도,1821,1053,948,873,47.94
2021-10-25 00:00:00.000,경상남도,1793,971,895,898,50.08
2021-10-25 00:00:00.000,전라남도,1514,863,788,726,47.95
2021-10-25 00:00:00.000,충청북도,1494,838,813,681,45.58
2021-10-25 00:00:00.000,부산광역시,1605,830,758,847,52.77
2021-10-25 00:00:00.000,전라북도,1446,782,746,700,48.41
2021-10-25 00:00:00.000,대전광역시,1196,680,635,561,46.91
2021-10-25 00:00:00.000,대구광역시,1014,546,555,459,45.27
2021-10-25 00:00:00.000,경기,727,511,400,327,44.98
2021-10-25 00:00:00.000,광주광역시,996,506,492,504,50.6
2021-10-25 00:00:00.000,제주특별자치도,697,380,358,339,48.64
2021-10-25 00:00:00.000,울산광역시,561,305,288,273,48.66
2021-10-25 00:00:00.000,세종특별자치시,422,228,222,200,47.39
2021-10-25 00:00:00.000,인천광역,150,105,81,69,46
2021-10-25 00:00:00.000,인천,121,82,61,60,49.59
2021-10-25 00:00:00.000,충남,97,62,49,48,49.48
2021-10-25 00:00:00.000,강원,90,58,49,41,45.56
2021-10-25 00:00:00.000,경북,72,44,37,35,48.61
2021-10-25 00:00:00.000,충북,66,41,40,26,39.39
2021-10-25 00:00:00.000,경남,65,40,31,34,52.31
2021-10-25 00:00:00.000,★★★★★★★★,36,31,19,17,47.22
2021-10-25 00:00:00.000,대전광역,37,28,25,12,32.43
2021-10-25 00:00:00.000,전북,38,25,23,15,39.47
2021-10-25 00:00:00.000,부산광역,52,25,19,33,63.46
2021-10-25 00:00:00.000,대전,34,25,16,18,52.94
2021-10-25 00:00:00.000,광주,36,23,18,18,50
2021-10-25 00:00:00.000,전남,30,21,18,12,40
2021-10-25 00:00:00.000,광주광역,28,19,10,18,64.29
2021-10-25 00:00:00.000,부산,30,16,21,9,30
2021-10-25 00:00:00.000,대구,26,16,10,16,61.54
2021-10-25 00:00:00.000,대구광역,25,16,16,9,36
2021-10-25 00:00:00.000,울산,17,12,11,6,35.29
2021-10-25 00:00:00.000,제주도,14,12,9,5,35.71
2021-10-25 00:00:00.000,제주,22,11,14,8,36.36
2021-10-25 00:00:00.000,울,17,10,10,7,41.18
2021-10-25 00:00:00.000,기,10,8,5,5,50
2021-10-25 00:00:00.000,서울강북구,13,8,6,7,53.85
2021-10-25 00:00:00.000,울산광역,5,3,4,1,20
2021-10-25 00:00:00.000,서울시,2,2,1,1,50
2021-10-25 00:00:00.000,북,4,2,1,3,75
2021-10-25 00:00:00.000,경남마산시해운동,2,1,0,2,100
2021-10-25 00:00:00.000,강북구,2,1,2,0,0
2021-10-25 00:00:00.000,원,1,1,1,0,0
2021-10-25 00:00:00.000,천,1,1,0,1,100
2021-10-25 00:00:00.000,남,1,1,1,0,0
2021-10-25 00:00:00.000,전,2,1,2,0,0
