"DATE","SIDO_ADDR","ROWCNT","PCNT","MED_Y_CNT","MED_N_CNT","MED_N_RATE"
2020-06-29 00:00:00.000,서울특별시,27988,18839,14651,13337,47.65
2020-06-29 00:00:00.000,경기도,10266,6762,5386,4880,47.54
2020-06-29 00:00:00.000,인천광역시,1665,1078,908,757,45.47
2020-06-29 00:00:00.000,서울,1365,1028,772,593,43.44
2020-06-29 00:00:00.000,충청남도,1272,792,638,634,49.84
2020-06-29 00:00:00.000,경상북도,1150,699,561,589,51.22
2020-06-29 00:00:00.000,강원도,961,624,513,448,46.62
2020-06-29 00:00:00.000,경상남도,896,534,428,468,52.23
2020-06-29 00:00:00.000,,654,505,414,240,36.7
2020-06-29 00:00:00.000,충청북도,765,471,412,353,46.14
2020-06-29 00:00:00.000,전라북도,744,455,361,383,51.48
2020-06-29 00:00:00.000,전라남도,734,433,369,365,49.73
2020-06-29 00:00:00.000,부산광역시,728,425,360,368,50.55
2020-06-29 00:00:00.000,대전광역시,625,390,315,310,49.6
2020-06-29 00:00:00.000,경기,436,324,230,206,47.25
2020-06-29 00:00:00.000,광주광역시,459,274,220,239,52.07
2020-06-29 00:00:00.000,대구광역시,437,268,208,229,52.4
2020-06-29 00:00:00.000,제주특별자치도,380,225,209,171,45
2020-06-29 00:00:00.000,울산광역시,307,184,150,157,51.14
2020-06-29 00:00:00.000,세종특별자치시,229,146,114,115,50.22
2020-06-29 00:00:00.000,인천광역,94,70,46,48,51.06
2020-06-29 00:00:00.000,충남,60,44,29,31,51.67
2020-06-29 00:00:00.000,인천,50,39,26,24,48
2020-06-29 00:00:00.000,경북,54,36,34,20,37.04
2020-06-29 00:00:00.000,강원,36,27,18,18,50
2020-06-29 00:00:00.000,경남,35,22,16,19,54.29
2020-06-29 00:00:00.000,전북,32,19,7,25,78.13
2020-06-29 00:00:00.000,부산광역,24,18,16,8,33.33
2020-06-29 00:00:00.000,광주광역,24,18,14,10,41.67
2020-06-29 00:00:00.000,충북,26,17,16,10,38.46
2020-06-29 00:00:00.000,전남,22,13,5,17,77.27
2020-06-29 00:00:00.000,대전,16,10,6,10,62.5
2020-06-29 00:00:00.000,대구,14,10,5,9,64.29
2020-06-29 00:00:00.000,대전광역,13,10,10,3,23.08
2020-06-29 00:00:00.000,★★★★★★★★,11,9,2,9,81.82
2020-06-29 00:00:00.000,대구광역,11,9,7,4,36.36
2020-06-29 00:00:00.000,부산,11,9,4,7,63.64
2020-06-29 00:00:00.000,광주,10,8,7,3,30
2020-06-29 00:00:00.000,울산,6,5,5,1,16.67
2020-06-29 00:00:00.000,남,5,4,3,2,40
2020-06-29 00:00:00.000,제주,7,4,4,3,42.86
2020-06-29 00:00:00.000,기,3,3,3,0,0
2020-06-29 00:00:00.000,울산광역,5,3,2,3,60
2020-06-29 00:00:00.000,울,3,3,3,0,0
2020-06-29 00:00:00.000,제주도,4,3,2,2,50
2020-06-29 00:00:00.000,서울시,2,2,1,1,50
2020-06-29 00:00:00.000,서울강북구,3,2,1,2,66.67
2020-06-29 00:00:00.000,주,2,1,0,2,100
2020-06-29 00:00:00.000,북,1,1,1,0,0
2020-06-29 00:00:00.000,천,1,1,1,0,0
2020-06-29 00:00:00.000,대동@,1,1,1,0,0
2020-06-29 00:00:00.000,광주시,2,1,1,1,50
2020-07-06 00:00:00.000,서울특별시,48410,30694,26513,21897,45.23
2020-07-06 00:00:00.000,경기도,17822,11070,9793,8029,45.05
2020-07-06 00:00:00.000,,6851,6630,693,6158,89.88
2020-07-06 00:00:00.000,서울,2575,1866,1348,1227,47.65
2020-07-06 00:00:00.000,인천광역시,2959,1790,1626,1333,45.05
2020-07-06 00:00:00.000,충청남도,2198,1343,1203,995,45.27
2020-07-06 00:00:00.000,경상북도,1999,1110,1029,970,48.52
2020-07-06 00:00:00.000,강원도,1737,1046,904,833,47.96
2020-07-06 00:00:00.000,경상남도,1555,891,811,744,47.85
2020-07-06 00:00:00.000,충청북도,1303,768,708,595,45.66
2020-07-06 00:00:00.000,전라남도,1329,720,688,641,48.23
2020-07-06 00:00:00.000,전라북도,1217,699,662,555,45.6
2020-07-06 00:00:00.000,부산광역시,1263,689,622,641,50.75
2020-07-06 00:00:00.000,대전광역시,1056,627,562,494,46.78
2020-07-06 00:00:00.000,경기,806,572,429,377,46.77
2020-07-06 00:00:00.000,대구광역시,859,508,445,414,48.2
2020-07-06 00:00:00.000,광주광역시,843,453,410,433,51.36
2020-07-06 00:00:00.000,제주특별자치도,740,370,367,373,50.41
2020-07-06 00:00:00.000,울산광역시,452,253,220,232,51.33
2020-07-06 00:00:00.000,세종특별자치시,347,200,181,166,47.84
2020-07-06 00:00:00.000,인천광역,157,107,81,76,48.41
2020-07-06 00:00:00.000,인천,125,87,71,54,43.2
2020-07-06 00:00:00.000,충남,104,70,52,52,50
2020-07-06 00:00:00.000,경북,81,52,38,43,53.09
2020-07-06 00:00:00.000,강원,71,47,38,33,46.48
2020-07-06 00:00:00.000,경남,51,38,23,28,54.9
2020-07-06 00:00:00.000,부산광역,49,32,25,24,48.98
2020-07-06 00:00:00.000,광주광역,41,29,24,17,41.46
2020-07-06 00:00:00.000,전북,46,28,27,19,41.3
2020-07-06 00:00:00.000,대전광역,34,26,13,21,61.76
2020-07-06 00:00:00.000,충북,35,23,19,16,45.71
2020-07-06 00:00:00.000,부산,33,19,17,16,48.48
2020-07-06 00:00:00.000,대구광역,27,18,13,14,51.85
2020-07-06 00:00:00.000,전남,28,17,16,12,42.86
2020-07-06 00:00:00.000,대구,33,17,8,25,75.76
2020-07-06 00:00:00.000,광주,23,17,17,6,26.09
2020-07-06 00:00:00.000,★★★★★★★★,19,15,9,10,52.63
2020-07-06 00:00:00.000,대전,27,13,14,13,48.15
2020-07-06 00:00:00.000,제주도,12,11,9,3,25
2020-07-06 00:00:00.000,울산,17,11,10,7,41.18
2020-07-06 00:00:00.000,제주,23,11,6,17,73.91
2020-07-06 00:00:00.000,울산광역,17,10,3,14,82.35
2020-07-06 00:00:00.000,울,12,9,6,6,50
2020-07-06 00:00:00.000,서울강북구,15,7,3,12,80
2020-07-06 00:00:00.000,기,7,5,4,3,42.86
2020-07-06 00:00:00.000,주,1,1,1,0,0
2020-07-06 00:00:00.000,북,2,1,0,2,100
2020-07-06 00:00:00.000,원,1,1,1,0,0
2020-07-06 00:00:00.000,광주시,1,1,1,0,0
2020-07-06 00:00:00.000,강서구,3,1,0,3,100
2020-07-06 00:00:00.000,강북구,1,1,1,0,0
2020-07-06 00:00:00.000,전,2,1,0,2,100
2020-07-06 00:00:00.000,서울시,2,1,0,2,100
2020-07-13 00:00:00.000,서울특별시,47840,30288,26622,21218,44.35
2020-07-13 00:00:00.000,경기도,17731,11021,9650,8081,45.58
2020-07-13 00:00:00.000,인천광역시,2876,1784,1555,1321,45.93
2020-07-13 00:00:00.000,서울,2402,1696,1363,1039,43.26
2020-07-13 00:00:00.000,충청남도,2205,1361,1194,1011,45.85
2020-07-13 00:00:00.000,경상북도,1912,1099,1010,902,47.18
2020-07-13 00:00:00.000,강원도,1735,1059,947,788,45.42
2020-07-13 00:00:00.000,경상남도,1653,933,836,817,49.43
2020-07-13 00:00:00.000,충청북도,1390,817,770,620,44.6
2020-07-13 00:00:00.000,,959,753,666,293,30.55
2020-07-13 00:00:00.000,전라남도,1289,708,692,597,46.31
2020-07-13 00:00:00.000,전라북도,1334,705,651,683,51.2
2020-07-13 00:00:00.000,부산광역시,1314,672,652,662,50.38
2020-07-13 00:00:00.000,대전광역시,1027,597,520,507,49.37
2020-07-13 00:00:00.000,경기,749,550,433,316,42.19
2020-07-13 00:00:00.000,대구광역시,888,484,457,431,48.54
2020-07-13 00:00:00.000,광주광역시,770,418,386,384,49.87
2020-07-13 00:00:00.000,제주특별자치도,653,338,354,299,45.79
2020-07-13 00:00:00.000,울산광역시,494,263,247,247,50
2020-07-13 00:00:00.000,세종특별자치시,327,192,193,134,40.98
2020-07-13 00:00:00.000,인천광역,117,92,68,49,41.88
2020-07-13 00:00:00.000,인천,89,60,41,48,53.93
2020-07-13 00:00:00.000,충남,85,59,50,35,41.18
2020-07-13 00:00:00.000,강원,69,45,33,36,52.17
2020-07-13 00:00:00.000,경남,60,40,28,32,53.33
2020-07-13 00:00:00.000,충북,42,34,24,18,42.86
2020-07-13 00:00:00.000,경북,52,33,26,26,50
2020-07-13 00:00:00.000,전남,49,28,19,30,61.22
2020-07-13 00:00:00.000,대구광역,35,23,18,17,48.57
2020-07-13 00:00:00.000,전북,35,22,14,21,60
2020-07-13 00:00:00.000,부산광역,28,21,16,12,42.86
2020-07-13 00:00:00.000,부산,31,20,17,14,45.16
2020-07-13 00:00:00.000,대전광역,30,20,12,18,60
2020-07-13 00:00:00.000,대전,24,19,9,15,62.5
2020-07-13 00:00:00.000,광주,25,15,9,16,64
2020-07-13 00:00:00.000,광주광역,20,14,7,13,65
2020-07-13 00:00:00.000,대구,25,14,17,8,32
2020-07-13 00:00:00.000,제주,19,13,11,8,42.11
2020-07-13 00:00:00.000,울산광역,13,11,9,4,30.77
2020-07-13 00:00:00.000,★★★★★★★★,12,11,5,7,58.33
2020-07-13 00:00:00.000,울,13,10,7,6,46.15
2020-07-13 00:00:00.000,울산,17,9,4,13,76.47
2020-07-13 00:00:00.000,제주도,13,7,8,5,38.46
2020-07-13 00:00:00.000,서울강북구,8,6,7,1,12.5
2020-07-13 00:00:00.000,기,6,3,3,3,50
2020-07-13 00:00:00.000,전,2,2,2,0,0
2020-07-13 00:00:00.000,강북구,2,2,2,0,0
2020-07-13 00:00:00.000,남,3,2,1,2,66.67
2020-07-13 00:00:00.000,천,1,1,1,0,0
2020-07-13 00:00:00.000,울주군,1,1,1,0,0
2020-07-13 00:00:00.000,서울시,4,1,1,3,75
2020-07-13 00:00:00.000,원,1,1,1,0,0
2020-07-13 00:00:00.000,산,2,1,1,1,50
2020-07-13 00:00:00.000,강서구,1,1,1,0,0
2020-07-13 00:00:00.000,북,1,1,1,0,0
2020-07-20 00:00:00.000,서울특별시,47701,30099,26548,21153,44.34
2020-07-20 00:00:00.000,경기도,17599,10920,9746,7853,44.62
2020-07-20 00:00:00.000,인천광역시,2967,1785,1693,1274,42.94
2020-07-20 00:00:00.000,서울,2259,1616,1291,968,42.85
2020-07-20 00:00:00.000,충청남도,2239,1368,1225,1014,45.29
2020-07-20 00:00:00.000,경상북도,2003,1150,1043,960,47.93
2020-07-20 00:00:00.000,강원도,1674,1022,931,743,44.38
2020-07-20 00:00:00.000,경상남도,1721,940,850,871,50.61
2020-07-20 00:00:00.000,충청북도,1343,799,754,589,43.86
2020-07-20 00:00:00.000,,955,769,693,262,27.43
2020-07-20 00:00:00.000,전라북도,1298,730,664,634,48.84
2020-07-20 00:00:00.000,부산광역시,1286,708,673,613,47.67
2020-07-20 00:00:00.000,전라남도,1240,698,657,583,47.02
2020-07-20 00:00:00.000,대전광역시,1159,654,582,577,49.78
2020-07-20 00:00:00.000,경기,818,559,438,380,46.45
2020-07-20 00:00:00.000,대구광역시,850,487,457,393,46.24
2020-07-20 00:00:00.000,광주광역시,740,418,385,355,47.97
2020-07-20 00:00:00.000,제주특별자치도,640,343,337,303,47.34
2020-07-20 00:00:00.000,울산광역시,490,274,246,244,49.8
2020-07-20 00:00:00.000,세종특별자치시,304,182,167,137,45.07
2020-07-20 00:00:00.000,인천광역,122,91,72,50,40.98
2020-07-20 00:00:00.000,인천,114,68,58,56,49.12
2020-07-20 00:00:00.000,충남,73,56,37,36,49.32
2020-07-20 00:00:00.000,경북,65,46,29,36,55.38
2020-07-20 00:00:00.000,강원,60,41,30,30,50
2020-07-20 00:00:00.000,충북,52,37,27,25,48.08
2020-07-20 00:00:00.000,전북,52,35,25,27,51.92
2020-07-20 00:00:00.000,경남,53,33,26,27,50.94
2020-07-20 00:00:00.000,전남,47,31,32,15,31.91
2020-07-20 00:00:00.000,부산광역,43,27,21,22,51.16
2020-07-20 00:00:00.000,광주광역,38,27,19,19,50
2020-07-20 00:00:00.000,대전,43,27,14,29,67.44
2020-07-20 00:00:00.000,대구광역,32,23,13,19,59.38
2020-07-20 00:00:00.000,부산,31,23,17,14,45.16
2020-07-20 00:00:00.000,대전광역,31,21,15,16,51.61
2020-07-20 00:00:00.000,광주,22,13,8,14,63.64
2020-07-20 00:00:00.000,대구,26,12,7,19,73.08
2020-07-20 00:00:00.000,울,12,11,8,4,33.33
2020-07-20 00:00:00.000,★★★★★★★★,13,10,6,7,53.85
2020-07-20 00:00:00.000,서울강북구,15,10,6,9,60
2020-07-20 00:00:00.000,제주,15,9,7,8,53.33
2020-07-20 00:00:00.000,울산,13,9,10,3,23.08
2020-07-20 00:00:00.000,제주도,16,7,8,8,50
2020-07-20 00:00:00.000,울산광역,5,3,3,2,40
2020-07-20 00:00:00.000,남,4,2,4,0,0
2020-07-20 00:00:00.000,강북구,6,2,1,5,83.33
2020-07-20 00:00:00.000,원,3,2,1,2,66.67
2020-07-20 00:00:00.000,경기도화성시송산동,2,1,1,1,50
2020-07-20 00:00:00.000,서울시,3,1,1,2,66.67
2020-07-20 00:00:00.000,서울관악구봉천1동,1,1,1,0,0
2020-07-20 00:00:00.000,남동구만수2동,1,1,1,0,0
2020-07-20 00:00:00.000,기,1,1,1,0,0
2020-07-20 00:00:00.000,경기용인시풍덕천2동,1,1,1,0,0
2020-07-20 00:00:00.000,광진구,2,1,1,1,50
2020-07-20 00:00:00.000,서울강북구번3동,2,1,1,1,50
2020-07-27 00:00:00.000,서울특별시,45841,29096,25230,20611,44.96
2020-07-27 00:00:00.000,경기도,17177,10741,9236,7941,46.23
2020-07-27 00:00:00.000,인천광역시,2835,1718,1498,1337,47.16
2020-07-27 00:00:00.000,서울,2176,1560,1213,963,44.26
2020-07-27 00:00:00.000,충청남도,2159,1321,1143,1016,47.06
2020-07-27 00:00:00.000,경상북도,1993,1132,970,1023,51.33
2020-07-27 00:00:00.000,강원도,1580,965,840,740,46.84
2020-07-27 00:00:00.000,경상남도,1604,892,829,775,48.32
2020-07-27 00:00:00.000,충청북도,1386,803,729,657,47.4
2020-07-27 00:00:00.000,,970,756,682,288,29.69
2020-07-27 00:00:00.000,전라북도,1266,707,660,606,47.87
2020-07-27 00:00:00.000,전라남도,1190,671,573,617,51.85
2020-07-27 00:00:00.000,대전광역시,1108,640,581,527,47.56
2020-07-27 00:00:00.000,부산광역시,1127,616,587,540,47.91
2020-07-27 00:00:00.000,경기,720,522,379,341,47.36
2020-07-27 00:00:00.000,대구광역시,860,475,439,421,48.95
2020-07-27 00:00:00.000,광주광역시,774,422,378,396,51.16
2020-07-27 00:00:00.000,제주특별자치도,617,329,317,300,48.62
2020-07-27 00:00:00.000,울산광역시,498,290,264,234,46.99
2020-07-27 00:00:00.000,세종특별자치시,340,202,187,153,45
2020-07-27 00:00:00.000,인천광역,119,84,65,54,45.38
2020-07-27 00:00:00.000,충남,86,63,47,39,45.35
2020-07-27 00:00:00.000,인천,81,61,40,41,50.62
2020-07-27 00:00:00.000,경북,76,47,36,40,52.63
2020-07-27 00:00:00.000,강원,62,45,37,25,40.32
2020-07-27 00:00:00.000,충북,62,43,35,27,43.55
2020-07-27 00:00:00.000,전북,61,38,31,30,49.18
2020-07-27 00:00:00.000,경남,56,37,30,26,46.43
2020-07-27 00:00:00.000,부산광역,38,24,16,22,57.89
2020-07-27 00:00:00.000,광주광역,35,22,19,16,45.71
2020-07-27 00:00:00.000,대전,30,22,16,14,46.67
2020-07-27 00:00:00.000,전남,29,21,13,16,55.17
2020-07-27 00:00:00.000,대구광역,24,20,14,10,41.67
2020-07-27 00:00:00.000,부산,35,20,17,18,51.43
2020-07-27 00:00:00.000,대전광역,27,17,14,13,48.15
2020-07-27 00:00:00.000,광주,29,16,11,18,62.07
2020-07-27 00:00:00.000,★★★★★★★★,16,11,5,11,68.75
2020-07-27 00:00:00.000,대구,16,11,9,7,43.75
2020-07-27 00:00:00.000,서울강북구,14,11,7,7,50
2020-07-27 00:00:00.000,울산,13,9,8,5,38.46
2020-07-27 00:00:00.000,울,9,8,9,0,0
2020-07-27 00:00:00.000,제주,11,8,6,5,45.45
2020-07-27 00:00:00.000,제주도,9,6,5,4,44.44
2020-07-27 00:00:00.000,울산광역,7,6,2,5,71.43
2020-07-27 00:00:00.000,기,4,2,1,3,75
2020-07-27 00:00:00.000,천,2,2,2,0,0
2020-07-27 00:00:00.000,산,4,2,3,1,25
2020-07-27 00:00:00.000,서울시,5,2,1,4,80
2020-07-27 00:00:00.000,강북구,3,2,1,2,66.67
2020-07-27 00:00:00.000,남,1,1,1,0,0
2020-07-27 00:00:00.000,원주시,5,1,2,3,60
2020-07-27 00:00:00.000,남동구만수2동,2,1,0,2,100
2020-07-27 00:00:00.000,북,2,1,0,2,100
2020-08-03 00:00:00.000,서울특별시,45747,29058,24631,21116,46.16
2020-08-03 00:00:00.000,경기도,17165,10763,9024,8141,47.43
2020-08-03 00:00:00.000,인천광역시,2891,1722,1518,1373,47.49
2020-08-03 00:00:00.000,서울,2216,1571,1215,1001,45.17
2020-08-03 00:00:00.000,충청남도,2173,1329,1155,1018,46.85
2020-08-03 00:00:00.000,경상북도,1931,1115,981,950,49.2
2020-08-03 00:00:00.000,강원도,1563,947,811,752,48.11
2020-08-03 00:00:00.000,경상남도,1661,914,785,876,52.74
2020-08-03 00:00:00.000,충청북도,1308,788,697,611,46.71
2020-08-03 00:00:00.000,,1056,787,659,397,37.59
2020-08-03 00:00:00.000,전라북도,1380,753,654,726,52.61
2020-08-03 00:00:00.000,전라남도,1287,692,649,638,49.57
2020-08-03 00:00:00.000,부산광역시,1246,677,602,644,51.69
2020-08-03 00:00:00.000,대전광역시,1110,613,529,581,52.34
2020-08-03 00:00:00.000,경기,726,517,401,325,44.77
2020-08-03 00:00:00.000,대구광역시,898,507,463,435,48.44
2020-08-03 00:00:00.000,광주광역시,809,460,409,400,49.44
2020-08-03 00:00:00.000,제주특별자치도,597,331,316,281,47.07
2020-08-03 00:00:00.000,울산광역시,483,281,253,230,47.62
2020-08-03 00:00:00.000,세종특별자치시,329,212,180,149,45.29
2020-08-03 00:00:00.000,인천광역,131,89,70,61,46.56
2020-08-03 00:00:00.000,충남,91,60,57,34,37.36
2020-08-03 00:00:00.000,인천,78,57,45,33,42.31
2020-08-03 00:00:00.000,경북,76,52,38,38,50
2020-08-03 00:00:00.000,경남,74,41,27,47,63.51
2020-08-03 00:00:00.000,전북,49,35,27,22,44.9
2020-08-03 00:00:00.000,충북,53,32,16,37,69.81
2020-08-03 00:00:00.000,강원,52,30,27,25,48.08
2020-08-03 00:00:00.000,부산,32,23,17,15,46.88
2020-08-03 00:00:00.000,광주광역,32,22,18,14,43.75
2020-08-03 00:00:00.000,부산광역,29,20,18,11,37.93
2020-08-03 00:00:00.000,울산,28,18,16,12,42.86
2020-08-03 00:00:00.000,대구광역,28,17,18,10,35.71
2020-08-03 00:00:00.000,광주,27,17,10,17,62.96
2020-08-03 00:00:00.000,대전광역,28,17,11,17,60.71
2020-08-03 00:00:00.000,대구,32,16,11,21,65.63
2020-08-03 00:00:00.000,전남,22,15,13,9,40.91
2020-08-03 00:00:00.000,★★★★★★★★,21,15,10,11,52.38
2020-08-03 00:00:00.000,대전,22,13,8,14,63.64
2020-08-03 00:00:00.000,제주,16,10,5,11,68.75
2020-08-03 00:00:00.000,서울강북구,12,9,6,6,50
2020-08-03 00:00:00.000,울,13,8,4,9,69.23
2020-08-03 00:00:00.000,울산광역,12,8,7,5,41.67
2020-08-03 00:00:00.000,제주도,12,8,6,6,50
2020-08-03 00:00:00.000,기,5,5,5,0,0
2020-08-03 00:00:00.000,서울시,7,4,2,5,71.43
2020-08-03 00:00:00.000,강북구,2,1,1,1,50
2020-08-03 00:00:00.000,천,3,1,0,3,100
2020-08-03 00:00:00.000,산,2,1,2,0,0
2020-08-03 00:00:00.000,원주시,1,1,1,0,0
2020-08-03 00:00:00.000,북,1,1,0,1,100
2020-08-03 00:00:00.000,원,2,1,2,0,0
2020-08-10 00:00:00.000,서울특별시,46894,30005,26200,20694,44.13
2020-08-10 00:00:00.000,경기도,17713,11079,9746,7967,44.98
2020-08-10 00:00:00.000,인천광역시,2919,1764,1582,1337,45.8
2020-08-10 00:00:00.000,서울,2266,1633,1312,954,42.1
2020-08-10 00:00:00.000,충청남도,2247,1384,1278,969,43.12
2020-08-10 00:00:00.000,경상북도,1925,1161,1039,886,46.03
2020-08-10 00:00:00.000,강원도,1641,996,886,755,46.01
2020-08-10 00:00:00.000,경상남도,1697,963,903,794,46.79
2020-08-10 00:00:00.000,충청북도,1403,837,810,593,42.27
2020-08-10 00:00:00.000,전라남도,1414,788,693,721,50.99
2020-08-10 00:00:00.000,전라북도,1307,768,705,602,46.06
2020-08-10 00:00:00.000,,1039,765,638,401,38.59
2020-08-10 00:00:00.000,부산광역시,1222,685,648,574,46.97
2020-08-10 00:00:00.000,대전광역시,1141,658,642,499,43.73
2020-08-10 00:00:00.000,대구광역시,992,572,556,436,43.95
2020-08-10 00:00:00.000,경기,748,523,411,337,45.05
2020-08-10 00:00:00.000,광주광역시,787,451,438,349,44.35
2020-08-10 00:00:00.000,제주특별자치도,606,328,303,303,50
2020-08-10 00:00:00.000,울산광역시,538,310,292,246,45.72
2020-08-10 00:00:00.000,세종특별자치시,365,222,197,168,46.03
2020-08-10 00:00:00.000,인천광역,130,85,61,69,53.08
2020-08-10 00:00:00.000,경북,95,62,54,41,43.16
2020-08-10 00:00:00.000,인천,78,59,42,36,46.15
2020-08-10 00:00:00.000,충남,78,50,41,37,47.44
2020-08-10 00:00:00.000,강원,68,43,39,29,42.65
2020-08-10 00:00:00.000,충북,58,40,21,37,63.79
2020-08-10 00:00:00.000,경남,62,36,32,30,48.39
2020-08-10 00:00:00.000,전남,38,28,18,20,52.63
2020-08-10 00:00:00.000,전북,45,25,22,23,51.11
2020-08-10 00:00:00.000,부산광역,34,24,19,15,44.12
2020-08-10 00:00:00.000,부산,38,22,21,17,44.74
2020-08-10 00:00:00.000,광주광역,39,22,22,17,43.59
2020-08-10 00:00:00.000,대구,30,20,17,13,43.33
2020-08-10 00:00:00.000,★★★★★★★★,21,17,9,12,57.14
2020-08-10 00:00:00.000,광주,38,15,11,27,71.05
2020-08-10 00:00:00.000,대전광역,19,14,10,9,47.37
2020-08-10 00:00:00.000,대전,24,14,13,11,45.83
2020-08-10 00:00:00.000,서울강북구,12,11,7,5,41.67
2020-08-10 00:00:00.000,대구광역,15,11,11,4,26.67
2020-08-10 00:00:00.000,울산,11,8,7,4,36.36
2020-08-10 00:00:00.000,울,7,7,5,2,28.57
2020-08-10 00:00:00.000,제주도,6,5,3,3,50
2020-08-10 00:00:00.000,서울시,8,5,4,4,50
2020-08-10 00:00:00.000,울산광역,9,5,4,5,55.56
2020-08-10 00:00:00.000,제주,6,4,2,4,66.67
2020-08-10 00:00:00.000,경기도양주군회천읍,1,1,0,1,100
2020-08-10 00:00:00.000,상주시,2,1,1,1,50
2020-08-10 00:00:00.000,세종시,2,1,2,0,0
2020-08-10 00:00:00.000,기,1,1,1,0,0
2020-08-10 00:00:00.000,산,2,1,2,0,0
2020-08-10 00:00:00.000,북,2,1,2,0,0
2020-08-10 00:00:00.000,남,1,1,1,0,0
2020-08-17 00:00:00.000,서울특별시,42482,26990,21971,20511,48.28
2020-08-17 00:00:00.000,경기도,15599,9767,8076,7523,48.23
2020-08-17 00:00:00.000,인천광역시,2700,1632,1390,1310,48.52
2020-08-17 00:00:00.000,서울,2006,1414,1100,906,45.16
2020-08-17 00:00:00.000,충청남도,1874,1152,979,895,47.76
2020-08-17 00:00:00.000,경상북도,1678,966,782,896,53.4
2020-08-17 00:00:00.000,강원도,1434,876,692,742,51.74
2020-08-17 00:00:00.000,경상남도,1420,801,678,742,52.25
2020-08-17 00:00:00.000,충청북도,1215,714,635,580,47.74
2020-08-17 00:00:00.000,,864,704,599,265,30.67
2020-08-17 00:00:00.000,전라북도,1188,676,539,649,54.63
2020-08-17 00:00:00.000,부산광역시,1163,638,553,610,52.45
2020-08-17 00:00:00.000,전라남도,1161,607,576,585,50.39
2020-08-17 00:00:00.000,대전광역시,891,535,454,437,49.05
2020-08-17 00:00:00.000,경기,778,528,390,388,49.87
2020-08-17 00:00:00.000,대구광역시,816,466,408,408,50
2020-08-17 00:00:00.000,광주광역시,640,353,306,334,52.19
2020-08-17 00:00:00.000,제주특별자치도,590,314,267,323,54.75
2020-08-17 00:00:00.000,울산광역시,405,232,204,201,49.63
2020-08-17 00:00:00.000,세종특별자치시,269,167,136,133,49.44
2020-08-17 00:00:00.000,인천광역,114,80,56,58,50.88
2020-08-17 00:00:00.000,충남,71,47,34,37,52.11
2020-08-17 00:00:00.000,인천,69,46,39,30,43.48
2020-08-17 00:00:00.000,경북,75,46,37,38,50.67
2020-08-17 00:00:00.000,경남,71,45,34,37,52.11
2020-08-17 00:00:00.000,충북,68,37,30,38,55.88
2020-08-17 00:00:00.000,강원,54,36,26,28,51.85
2020-08-17 00:00:00.000,전북,40,28,12,28,70
2020-08-17 00:00:00.000,전남,32,23,11,21,65.63
2020-08-17 00:00:00.000,대전,34,21,17,17,50
2020-08-17 00:00:00.000,광주,31,21,15,16,51.61
2020-08-17 00:00:00.000,광주광역,34,21,11,23,67.65
2020-08-17 00:00:00.000,부산,34,19,11,23,67.65
2020-08-17 00:00:00.000,부산광역,25,18,7,18,72
2020-08-17 00:00:00.000,대전광역,25,17,17,8,32
2020-08-17 00:00:00.000,★★★★★★★★,13,11,4,9,69.23
2020-08-17 00:00:00.000,대구광역,13,10,7,6,46.15
2020-08-17 00:00:00.000,울,15,10,7,8,53.33
2020-08-17 00:00:00.000,울산광역,15,10,8,7,46.67
2020-08-17 00:00:00.000,대구,18,10,5,13,72.22
2020-08-17 00:00:00.000,제주,7,7,6,1,14.29
2020-08-17 00:00:00.000,울산,10,7,6,4,40
2020-08-17 00:00:00.000,서울시,9,5,3,6,66.67
2020-08-17 00:00:00.000,서울강북구,4,4,2,2,50
2020-08-17 00:00:00.000,남,6,3,4,2,33.33
2020-08-17 00:00:00.000,제주도,8,3,4,4,50
2020-08-17 00:00:00.000,기,3,2,1,2,66.67
2020-08-17 00:00:00.000,천,1,1,0,1,100
2020-08-17 00:00:00.000,경기도화성시송산동,1,1,0,1,100
2020-08-17 00:00:00.000,산,4,1,3,1,25
2020-08-17 00:00:00.000,서울관악구봉천1동,1,1,1,0,0
2020-08-17 00:00:00.000,주,3,1,2,1,33.33
2020-08-24 00:00:00.000,서울특별시,42190,26214,22143,20047,47.52
2020-08-24 00:00:00.000,경기도,15891,9778,8253,7638,48.06
2020-08-24 00:00:00.000,인천광역시,2700,1622,1325,1375,50.93
2020-08-24 00:00:00.000,서울,2025,1410,1031,994,49.09
2020-08-24 00:00:00.000,충청남도,1706,1038,893,813,47.66
2020-08-24 00:00:00.000,경상북도,1581,911,765,816,51.61
2020-08-24 00:00:00.000,강원도,1427,850,683,744,52.14
2020-08-24 00:00:00.000,경상남도,1346,751,635,711,52.82
2020-08-24 00:00:00.000,충청북도,1159,671,562,597,51.51
2020-08-24 00:00:00.000,,814,634,541,273,33.54
2020-08-24 00:00:00.000,전라북도,1108,625,517,591,53.34
2020-08-24 00:00:00.000,부산광역시,1112,616,536,576,51.8
2020-08-24 00:00:00.000,전라남도,1067,594,552,515,48.27
2020-08-24 00:00:00.000,대전광역시,996,571,517,479,48.09
2020-08-24 00:00:00.000,경기,736,510,361,375,50.95
2020-08-24 00:00:00.000,대구광역시,784,419,364,420,53.57
2020-08-24 00:00:00.000,광주광역시,672,378,326,346,51.49
2020-08-24 00:00:00.000,제주특별자치도,566,305,273,293,51.77
2020-08-24 00:00:00.000,울산광역시,463,254,245,218,47.08
2020-08-24 00:00:00.000,세종특별자치시,273,162,137,136,49.82
2020-08-24 00:00:00.000,인천광역,114,78,57,57,50
2020-08-24 00:00:00.000,인천,69,53,37,32,46.38
2020-08-24 00:00:00.000,충남,78,53,41,37,47.44
2020-08-24 00:00:00.000,경북,75,47,36,39,52
2020-08-24 00:00:00.000,충북,61,45,36,25,40.98
2020-08-24 00:00:00.000,강원,68,43,25,43,63.24
2020-08-24 00:00:00.000,경남,44,28,19,25,56.82
2020-08-24 00:00:00.000,대전광역,34,24,13,21,61.76
2020-08-24 00:00:00.000,전남,40,21,10,30,75
2020-08-24 00:00:00.000,광주,25,20,15,10,40
2020-08-24 00:00:00.000,부산광역,31,20,14,17,54.84
2020-08-24 00:00:00.000,광주광역,27,20,14,13,48.15
2020-08-24 00:00:00.000,대전,31,19,12,19,61.29
2020-08-24 00:00:00.000,전북,26,18,15,11,42.31
2020-08-24 00:00:00.000,★★★★★★★★,20,16,6,14,70
2020-08-24 00:00:00.000,부산,19,12,13,6,31.58
2020-08-24 00:00:00.000,대구,17,11,6,11,64.71
2020-08-24 00:00:00.000,대구광역,9,7,7,2,22.22
2020-08-24 00:00:00.000,서울강북구,11,7,6,5,45.45
2020-08-24 00:00:00.000,울산,9,6,3,6,66.67
2020-08-24 00:00:00.000,제주도,6,5,2,4,66.67
2020-08-24 00:00:00.000,제주,8,5,2,6,75
2020-08-24 00:00:00.000,울,6,5,3,3,50
2020-08-24 00:00:00.000,울산광역,7,3,5,2,28.57
2020-08-24 00:00:00.000,서울시,3,2,1,2,66.67
2020-08-24 00:00:00.000,산,2,1,2,0,0
2020-08-24 00:00:00.000,남,1,1,1,0,0
2020-08-24 00:00:00.000,북,1,1,1,0,0
2020-08-24 00:00:00.000,기,1,1,0,1,100
2020-08-24 00:00:00.000,원주시,1,1,1,0,0
2020-08-24 00:00:00.000,천,1,1,1,0,0
2020-08-31 00:00:00.000,서울특별시,42703,26218,22698,20005,46.85
2020-08-31 00:00:00.000,경기도,15147,9484,7836,7311,48.27
2020-08-31 00:00:00.000,인천광역시,2586,1531,1334,1252,48.41
2020-08-31 00:00:00.000,서울,2015,1426,1047,968,48.04
2020-08-31 00:00:00.000,충청남도,1818,1047,927,891,49.01
2020-08-31 00:00:00.000,경상북도,1487,853,675,812,54.61
2020-08-31 00:00:00.000,강원도,1388,836,682,706,50.86
2020-08-31 00:00:00.000,충청북도,1121,685,579,542,48.35
2020-08-31 00:00:00.000,경상남도,1238,664,549,689,55.65
2020-08-31 00:00:00.000,,832,612,487,345,41.47
2020-08-31 00:00:00.000,전라북도,1054,584,498,556,52.75
2020-08-31 00:00:00.000,대전광역시,956,546,453,503,52.62
2020-08-31 00:00:00.000,부산광역시,932,526,457,475,50.97
2020-08-31 00:00:00.000,전라남도,955,515,444,511,53.51
2020-08-31 00:00:00.000,경기,583,430,295,288,49.4
2020-08-31 00:00:00.000,대구광역시,718,379,326,392,54.6
2020-08-31 00:00:00.000,광주광역시,608,352,316,292,48.03
2020-08-31 00:00:00.000,제주특별자치도,485,264,202,283,58.35
2020-08-31 00:00:00.000,울산광역시,358,204,157,201,56.15
2020-08-31 00:00:00.000,세종특별자치시,279,168,131,148,53.05
2020-08-31 00:00:00.000,인천광역,117,86,58,59,50.43
2020-08-31 00:00:00.000,인천,79,59,37,42,53.16
2020-08-31 00:00:00.000,충남,62,44,32,30,48.39
2020-08-31 00:00:00.000,경남,53,36,26,27,50.94
2020-08-31 00:00:00.000,강원,42,31,21,21,50
2020-08-31 00:00:00.000,경북,51,30,16,35,68.63
2020-08-31 00:00:00.000,부산광역,37,24,16,21,56.76
2020-08-31 00:00:00.000,충북,29,21,14,15,51.72
2020-08-31 00:00:00.000,전남,33,21,15,18,54.55
2020-08-31 00:00:00.000,전북,31,21,9,22,70.97
2020-08-31 00:00:00.000,광주광역,23,20,14,9,39.13
2020-08-31 00:00:00.000,대전광역,30,19,13,17,56.67
2020-08-31 00:00:00.000,★★★★★★★★,18,17,6,12,66.67
2020-08-31 00:00:00.000,대전,28,16,12,16,57.14
2020-08-31 00:00:00.000,광주,18,15,12,6,33.33
2020-08-31 00:00:00.000,대구,13,9,4,9,69.23
2020-08-31 00:00:00.000,부산,11,9,6,5,45.45
2020-08-31 00:00:00.000,울산,15,8,8,7,46.67
2020-08-31 00:00:00.000,서울강북구,9,7,4,5,55.56
2020-08-31 00:00:00.000,울,9,7,6,3,33.33
2020-08-31 00:00:00.000,제주,11,6,6,5,45.45
2020-08-31 00:00:00.000,제주도,5,4,3,2,40
2020-08-31 00:00:00.000,서울시,6,3,1,5,83.33
2020-08-31 00:00:00.000,울산광역,4,3,2,2,50
2020-08-31 00:00:00.000,대구광역,3,3,2,1,33.33
2020-08-31 00:00:00.000,천,4,2,0,4,100
2020-08-31 00:00:00.000,기,4,2,1,3,75
2020-08-31 00:00:00.000,산,3,1,0,3,100
2020-08-31 00:00:00.000,원주시,1,1,1,0,0
2020-08-31 00:00:00.000,경기도용인시서천동,1,1,0,1,100
2020-08-31 00:00:00.000,남,6,1,0,6,100
2020-08-31 00:00:00.000,주,2,1,1,1,50
2020-08-31 00:00:00.000,북,2,1,1,1,50
2020-09-07 00:00:00.000,서울특별시,44729,27670,24491,20238,45.25
2020-09-07 00:00:00.000,경기도,16497,10197,8867,7630,46.25
2020-09-07 00:00:00.000,인천광역시,2736,1641,1465,1271,46.45
2020-09-07 00:00:00.000,서울,2070,1462,1096,974,47.05
2020-09-07 00:00:00.000,충청남도,1942,1181,1051,891,45.88
2020-09-07 00:00:00.000,경상북도,1635,963,797,838,51.25
2020-09-07 00:00:00.000,강원도,1445,882,747,698,48.3
2020-09-07 00:00:00.000,경상남도,1445,774,720,725,50.17
2020-09-07 00:00:00.000,충청북도,1198,707,663,535,44.66
2020-09-07 00:00:00.000,,855,652,519,336,39.3
2020-09-07 00:00:00.000,전라북도,1149,630,584,565,49.17
2020-09-07 00:00:00.000,대전광역시,1025,611,534,491,47.9
2020-09-07 00:00:00.000,전라남도,1103,602,556,547,49.59
2020-09-07 00:00:00.000,부산광역시,1124,586,517,607,54
2020-09-07 00:00:00.000,경기,737,513,395,342,46.4
2020-09-07 00:00:00.000,대구광역시,829,441,403,426,51.39
2020-09-07 00:00:00.000,광주광역시,757,417,347,410,54.16
2020-09-07 00:00:00.000,제주특별자치도,555,286,266,289,52.07
2020-09-07 00:00:00.000,울산광역시,428,232,188,240,56.07
2020-09-07 00:00:00.000,세종특별자치시,346,191,178,168,48.55
2020-09-07 00:00:00.000,인천광역,122,87,69,53,43.44
2020-09-07 00:00:00.000,인천,91,59,46,45,49.45
2020-09-07 00:00:00.000,충남,81,51,36,45,55.56
2020-09-07 00:00:00.000,강원,56,39,29,27,48.21
2020-09-07 00:00:00.000,경북,53,34,26,27,50.94
2020-09-07 00:00:00.000,경남,46,27,12,34,73.91
2020-09-07 00:00:00.000,전북,26,22,13,13,50
2020-09-07 00:00:00.000,전남,24,20,19,5,20.83
2020-09-07 00:00:00.000,대전,36,19,10,26,72.22
2020-09-07 00:00:00.000,대전광역,22,18,8,14,63.64
2020-09-07 00:00:00.000,부산광역,21,16,14,7,33.33
2020-09-07 00:00:00.000,광주광역,21,15,10,11,52.38
2020-09-07 00:00:00.000,충북,19,13,8,11,57.89
2020-09-07 00:00:00.000,★★★★★★★★,15,12,3,12,80
2020-09-07 00:00:00.000,광주,16,12,11,5,31.25
2020-09-07 00:00:00.000,부산,20,12,6,14,70
2020-09-07 00:00:00.000,울산,20,11,7,13,65
2020-09-07 00:00:00.000,대구광역,13,10,5,8,61.54
2020-09-07 00:00:00.000,제주도,11,9,3,8,72.73
2020-09-07 00:00:00.000,대구,14,9,7,7,50
2020-09-07 00:00:00.000,제주,16,9,6,10,62.5
2020-09-07 00:00:00.000,울,8,7,5,3,37.5
2020-09-07 00:00:00.000,기,8,4,3,5,62.5
2020-09-07 00:00:00.000,서울강북구,7,4,2,5,71.43
2020-09-07 00:00:00.000,울산광역,4,4,3,1,25
2020-09-07 00:00:00.000,천,4,3,4,0,0
2020-09-07 00:00:00.000,서울시,6,3,1,5,83.33
2020-09-07 00:00:00.000,남,1,1,1,0,0
2020-09-07 00:00:00.000,경기도용인시서천동,1,1,0,1,100
2020-09-07 00:00:00.000,주,2,1,0,2,100
2020-09-07 00:00:00.000,경기용인시풍덕천2동,1,1,0,1,100
2020-09-07 00:00:00.000,경기의왕시포일동,2,1,1,1,50
2020-09-07 00:00:00.000,산,3,1,1,2,66.67
2020-09-14 00:00:00.000,서울특별시,46657,29606,26354,20303,43.52
2020-09-14 00:00:00.000,경기도,17167,10810,9660,7507,43.73
2020-09-14 00:00:00.000,서울,2397,1672,1348,1049,43.76
2020-09-14 00:00:00.000,인천광역시,2655,1659,1509,1146,43.16
2020-09-14 00:00:00.000,충청남도,1960,1220,1056,904,46.12
2020-09-14 00:00:00.000,경상북도,1731,1023,900,831,48.01
2020-09-14 00:00:00.000,강원도,1638,987,890,748,45.67
2020-09-14 00:00:00.000,,975,779,655,320,32.82
2020-09-14 00:00:00.000,경상남도,1386,774,716,670,48.34
2020-09-14 00:00:00.000,충청북도,1244,749,673,571,45.9
2020-09-14 00:00:00.000,전라남도,1199,660,589,610,50.88
2020-09-14 00:00:00.000,전라북도,1159,645,586,573,49.44
2020-09-14 00:00:00.000,부산광역시,1163,643,572,591,50.82
2020-09-14 00:00:00.000,대전광역시,1057,627,577,480,45.41
2020-09-14 00:00:00.000,경기,680,492,407,273,40.15
2020-09-14 00:00:00.000,대구광역시,801,447,396,405,50.56
2020-09-14 00:00:00.000,광주광역시,727,404,383,344,47.32
2020-09-14 00:00:00.000,제주특별자치도,578,329,299,279,48.27
2020-09-14 00:00:00.000,울산광역시,446,249,244,202,45.29
2020-09-14 00:00:00.000,세종특별자치시,301,180,164,137,45.51
2020-09-14 00:00:00.000,인천광역,111,84,59,52,46.85
2020-09-14 00:00:00.000,인천,105,75,60,45,42.86
2020-09-14 00:00:00.000,충남,86,56,36,50,58.14
2020-09-14 00:00:00.000,강원,56,40,28,28,50
2020-09-14 00:00:00.000,경북,59,39,33,26,44.07
2020-09-14 00:00:00.000,경남,39,26,20,19,48.72
2020-09-14 00:00:00.000,대전광역,38,25,16,22,57.89
2020-09-14 00:00:00.000,부산,39,23,15,24,61.54
2020-09-14 00:00:00.000,대전,51,23,15,36,70.59
2020-09-14 00:00:00.000,부산광역,34,21,13,21,61.76
2020-09-14 00:00:00.000,충북,31,20,14,17,54.84
2020-09-14 00:00:00.000,전남,29,19,12,17,58.62
2020-09-14 00:00:00.000,광주광역,22,15,9,13,59.09
2020-09-14 00:00:00.000,전북,23,14,12,11,47.83
2020-09-14 00:00:00.000,★★★★★★★★,16,14,9,7,43.75
2020-09-14 00:00:00.000,대구,23,14,13,10,43.48
2020-09-14 00:00:00.000,울산,17,12,12,5,29.41
2020-09-14 00:00:00.000,대구광역,11,9,6,5,45.45
2020-09-14 00:00:00.000,광주,12,9,7,5,41.67
2020-09-14 00:00:00.000,울산광역,13,8,5,8,61.54
2020-09-14 00:00:00.000,울,10,7,5,5,50
2020-09-14 00:00:00.000,서울강북구,8,6,6,2,25
2020-09-14 00:00:00.000,제주,18,6,2,16,88.89
2020-09-14 00:00:00.000,기,9,6,2,7,77.78
2020-09-14 00:00:00.000,서울시,6,4,2,4,66.67
2020-09-14 00:00:00.000,제주도,4,3,3,1,25
2020-09-14 00:00:00.000,남,3,2,1,2,66.67
2020-09-14 00:00:00.000,산,2,2,1,1,50
2020-09-14 00:00:00.000,서울관악구봉천1동,2,2,2,0,0
2020-09-14 00:00:00.000,원,2,2,2,0,0
2020-09-14 00:00:00.000,주,1,1,1,0,0
2020-09-14 00:00:00.000,서대문구,1,1,1,0,0
2020-09-14 00:00:00.000,강북구,2,1,0,2,100
2020-09-14 00:00:00.000,경기도화성시송산동,1,1,1,0,0
2020-09-14 00:00:00.000,인천직할시,1,1,1,0,0
2020-09-14 00:00:00.000,경기용인시풍덕천2동,2,1,1,1,50
2020-09-14 00:00:00.000,서구,2,1,0,2,100
2020-09-14 00:00:00.000,전,1,1,1,0,0
2020-09-21 00:00:00.000,서울특별시,50056,31213,28493,21563,43.08
2020-09-21 00:00:00.000,경기도,18753,11542,10589,8164,43.53
2020-09-21 00:00:00.000,인천광역시,3108,1859,1681,1427,45.91
2020-09-21 00:00:00.000,서울,2400,1711,1410,990,41.25
2020-09-21 00:00:00.000,충청남도,2120,1277,1158,962,45.38
2020-09-21 00:00:00.000,경상북도,1923,1082,1008,915,47.58
2020-09-21 00:00:00.000,강원도,1780,1027,971,809,45.45
2020-09-21 00:00:00.000,경상남도,1563,846,820,743,47.54
2020-09-21 00:00:00.000,충청북도,1418,821,783,635,44.78
2020-09-21 00:00:00.000,,990,772,665,325,32.83
2020-09-21 00:00:00.000,전라남도,1389,744,728,661,47.59
2020-09-21 00:00:00.000,부산광역시,1279,704,641,638,49.88
2020-09-21 00:00:00.000,전라북도,1197,673,636,561,46.87
2020-09-21 00:00:00.000,대전광역시,1154,650,635,519,44.97
2020-09-21 00:00:00.000,경기,777,545,431,346,44.53
2020-09-21 00:00:00.000,대구광역시,856,461,447,409,47.78
2020-09-21 00:00:00.000,광주광역시,836,455,452,384,45.93
2020-09-21 00:00:00.000,제주특별자치도,617,332,330,287,46.52
2020-09-21 00:00:00.000,울산광역시,443,251,217,226,51.02
2020-09-21 00:00:00.000,세종특별자치시,315,191,189,126,40
2020-09-21 00:00:00.000,인천광역,138,100,87,51,36.96
2020-09-21 00:00:00.000,인천,90,64,48,42,46.67
2020-09-21 00:00:00.000,강원,82,56,42,40,48.78
2020-09-21 00:00:00.000,충남,67,48,42,25,37.31
2020-09-21 00:00:00.000,경북,51,38,31,20,39.22
2020-09-21 00:00:00.000,경남,63,36,20,43,68.25
2020-09-21 00:00:00.000,충북,46,33,24,22,47.83
2020-09-21 00:00:00.000,전북,43,29,28,15,34.88
2020-09-21 00:00:00.000,광주광역,36,28,15,21,58.33
2020-09-21 00:00:00.000,전남,39,26,14,25,64.1
2020-09-21 00:00:00.000,대전광역,36,24,19,17,47.22
2020-09-21 00:00:00.000,부산광역,25,20,12,13,52
2020-09-21 00:00:00.000,대구광역,28,20,14,14,50
2020-09-21 00:00:00.000,대전,32,20,23,9,28.13
2020-09-21 00:00:00.000,부산,34,19,17,17,50
2020-09-21 00:00:00.000,대구,17,13,10,7,41.18
2020-09-21 00:00:00.000,광주,22,13,13,9,40.91
2020-09-21 00:00:00.000,★★★★★★★★,12,10,8,4,33.33
2020-09-21 00:00:00.000,울산,11,8,5,6,54.55
2020-09-21 00:00:00.000,제주,9,7,5,4,44.44
2020-09-21 00:00:00.000,울산광역,7,6,6,1,14.29
2020-09-21 00:00:00.000,울,6,6,5,1,16.67
2020-09-21 00:00:00.000,서울강북구,7,6,4,3,42.86
2020-09-21 00:00:00.000,제주도,7,6,4,3,42.86
2020-09-21 00:00:00.000,서울시,7,4,2,5,71.43
2020-09-21 00:00:00.000,북,6,3,4,2,33.33
2020-09-21 00:00:00.000,기,7,3,4,3,42.86
2020-09-21 00:00:00.000,남,3,2,1,2,66.67
2020-09-21 00:00:00.000,강북구,2,2,2,0,0
2020-09-21 00:00:00.000,서구,3,1,1,2,66.67
2020-09-21 00:00:00.000,광진구,1,1,1,0,0
2020-09-21 00:00:00.000,인천직할시,1,1,1,0,0
2020-09-21 00:00:00.000,광주시,2,1,1,1,50
2020-09-21 00:00:00.000,산,3,1,3,0,0
2020-09-28 00:00:00.000,서울특별시,22102,15330,12312,9790,44.29
2020-09-28 00:00:00.000,경기도,8029,5410,4477,3552,44.24
2020-09-28 00:00:00.000,인천광역시,1443,938,811,632,43.8
2020-09-28 00:00:00.000,서울,937,717,526,411,43.86
2020-09-28 00:00:00.000,충청남도,735,500,406,329,44.76
2020-09-28 00:00:00.000,강원도,635,428,374,261,41.1
2020-09-28 00:00:00.000,경상북도,661,427,299,362,54.77
2020-09-28 00:00:00.000,충청북도,567,367,302,265,46.74
2020-09-28 00:00:00.000,경상남도,547,325,240,307,56.12
2020-09-28 00:00:00.000,,408,319,275,133,32.6
2020-09-28 00:00:00.000,대전광역시,463,271,248,215,46.44
2020-09-28 00:00:00.000,부산광역시,443,266,210,233,52.6
2020-09-28 00:00:00.000,전라북도,410,265,207,203,49.51
2020-09-28 00:00:00.000,경기,320,242,186,134,41.88
2020-09-28 00:00:00.000,전라남도,401,238,193,208,51.87
2020-09-28 00:00:00.000,광주광역시,260,168,136,124,47.69
2020-09-28 00:00:00.000,대구광역시,294,161,135,159,54.08
2020-09-28 00:00:00.000,제주특별자치도,239,142,125,114,47.7
2020-09-28 00:00:00.000,울산광역시,178,104,87,91,51.12
2020-09-28 00:00:00.000,세종특별자치시,140,82,68,72,51.43
2020-09-28 00:00:00.000,인천광역,50,37,31,19,38
2020-09-28 00:00:00.000,인천,43,30,26,17,39.53
2020-09-28 00:00:00.000,충남,32,25,17,15,46.88
2020-09-28 00:00:00.000,강원,27,22,18,9,33.33
2020-09-28 00:00:00.000,경북,25,17,11,14,56
2020-09-28 00:00:00.000,충북,19,15,9,10,52.63
2020-09-28 00:00:00.000,경남,16,13,8,8,50
2020-09-28 00:00:00.000,부산광역,16,11,5,11,68.75
2020-09-28 00:00:00.000,전남,16,9,5,11,68.75
2020-09-28 00:00:00.000,★★★★★★★★,9,8,5,4,44.44
2020-09-28 00:00:00.000,전북,11,8,6,5,45.45
2020-09-28 00:00:00.000,대전광역,10,7,8,2,20
2020-09-28 00:00:00.000,대전,9,7,3,6,66.67
2020-09-28 00:00:00.000,대구,9,6,4,5,55.56
2020-09-28 00:00:00.000,광주,7,5,2,5,71.43
2020-09-28 00:00:00.000,대구광역,4,4,4,0,0
2020-09-28 00:00:00.000,제주도,3,3,1,2,66.67
2020-09-28 00:00:00.000,울,4,3,1,3,75
2020-09-28 00:00:00.000,제주,4,3,2,2,50
2020-09-28 00:00:00.000,기,4,2,1,3,75
2020-09-28 00:00:00.000,울산,4,2,3,1,25
2020-09-28 00:00:00.000,광주광역,3,2,1,2,66.67
2020-09-28 00:00:00.000,서울강북구,2,2,2,0,0
2020-09-28 00:00:00.000,부산,2,2,1,1,50
2020-09-28 00:00:00.000,남,1,1,1,0,0
2020-09-28 00:00:00.000,울산광역,1,1,1,0,0
2020-09-28 00:00:00.000,인천시,1,1,1,0,0
2020-09-28 00:00:00.000,서울시,1,1,1,0,0
2020-09-28 00:00:00.000,원주시,2,1,0,2,100
2020-10-05 00:00:00.000,서울특별시,44850,28713,25157,19693,43.91
2020-10-05 00:00:00.000,경기도,16660,10329,9228,7432,44.61
2020-10-05 00:00:00.000,인천광역시,2920,1746,1592,1328,45.48
2020-10-05 00:00:00.000,서울,1999,1458,1171,828,41.42
2020-10-05 00:00:00.000,충청남도,1954,1182,1062,892,45.65
2020-10-05 00:00:00.000,경상북도,1812,1066,941,871,48.07
2020-10-05 00:00:00.000,강원도,1566,947,883,683,43.61
2020-10-05 00:00:00.000,경상남도,1484,824,773,711,47.91
2020-10-05 00:00:00.000,충청북도,1283,761,718,565,44.04
2020-10-05 00:00:00.000,,885,702,644,241,27.23
2020-10-05 00:00:00.000,전라남도,1244,670,632,612,49.2
2020-10-05 00:00:00.000,전라북도,1163,666,642,521,44.8
2020-10-05 00:00:00.000,부산광역시,1207,642,638,569,47.14
2020-10-05 00:00:00.000,대전광역시,1091,606,587,504,46.2
2020-10-05 00:00:00.000,경기,671,482,384,287,42.77
2020-10-05 00:00:00.000,대구광역시,790,441,426,364,46.08
2020-10-05 00:00:00.000,광주광역시,748,406,399,349,46.66
2020-10-05 00:00:00.000,제주특별자치도,588,321,309,279,47.45
2020-10-05 00:00:00.000,울산광역시,446,244,220,226,50.67
2020-10-05 00:00:00.000,세종특별자치시,345,207,200,145,42.03
2020-10-05 00:00:00.000,인천광역,111,89,66,45,40.54
2020-10-05 00:00:00.000,인천,74,53,39,35,47.3
2020-10-05 00:00:00.000,충남,69,52,38,31,44.93
2020-10-05 00:00:00.000,경북,65,43,30,35,53.85
2020-10-05 00:00:00.000,강원,42,32,21,21,50
2020-10-05 00:00:00.000,충북,45,30,23,22,48.89
2020-10-05 00:00:00.000,전북,40,29,27,13,32.5
2020-10-05 00:00:00.000,전남,40,27,20,20,50
2020-10-05 00:00:00.000,경남,35,25,21,14,40
2020-10-05 00:00:00.000,부산,33,21,16,17,51.52
2020-10-05 00:00:00.000,부산광역,25,17,20,5,20
2020-10-05 00:00:00.000,대전광역,22,16,11,11,50
2020-10-05 00:00:00.000,울산,21,16,13,8,38.1
2020-10-05 00:00:00.000,광주,26,15,10,16,61.54
2020-10-05 00:00:00.000,대전,17,14,12,5,29.41
2020-10-05 00:00:00.000,대구광역,19,14,10,9,47.37
2020-10-05 00:00:00.000,★★★★★★★★,16,12,8,8,50
2020-10-05 00:00:00.000,광주광역,13,11,6,7,53.85
2020-10-05 00:00:00.000,대구,19,11,8,11,57.89
2020-10-05 00:00:00.000,제주,12,7,5,7,58.33
2020-10-05 00:00:00.000,제주도,7,5,5,2,28.57
2020-10-05 00:00:00.000,울,4,4,3,1,25
2020-10-05 00:00:00.000,서울강북구,3,3,2,1,33.33
2020-10-05 00:00:00.000,울산광역,4,3,1,3,75
2020-10-05 00:00:00.000,기,4,3,1,3,75
2020-10-05 00:00:00.000,서울시,4,2,1,3,75
2020-10-05 00:00:00.000,남,3,2,3,0,0
2020-10-05 00:00:00.000,북,1,1,0,1,100
2020-10-05 00:00:00.000,산,2,1,2,0,0
2020-10-05 00:00:00.000,경기용인시풍덕천2동,1,1,1,0,0
2020-10-05 00:00:00.000,광진구,1,1,1,0,0
2020-10-05 00:00:00.000,강북구,1,1,1,0,0
2020-10-12 00:00:00.000,서울특별시,42799,27692,23389,19410,45.35
2020-10-12 00:00:00.000,경기도,15872,10023,8639,7233,45.57
2020-10-12 00:00:00.000,인천광역시,2661,1618,1417,1244,46.75
2020-10-12 00:00:00.000,서울,1945,1422,1067,878,45.14
2020-10-12 00:00:00.000,충청남도,1941,1182,1049,892,45.96
2020-10-12 00:00:00.000,경상북도,1718,1003,899,819,47.67
2020-10-12 00:00:00.000,강원도,1532,916,784,748,48.83
2020-10-12 00:00:00.000,경상남도,1522,850,761,761,50
2020-10-12 00:00:00.000,,1013,793,726,287,28.33
2020-10-12 00:00:00.000,충청북도,1253,747,710,543,43.34
2020-10-12 00:00:00.000,전라남도,1253,697,608,645,51.48
2020-10-12 00:00:00.000,부산광역시,1136,621,582,554,48.77
2020-10-12 00:00:00.000,전라북도,1031,616,503,528,51.21
2020-10-12 00:00:00.000,대전광역시,1029,573,511,518,50.34
2020-10-12 00:00:00.000,경기,643,468,360,283,44.01
2020-10-12 00:00:00.000,대구광역시,749,420,392,357,47.66
2020-10-12 00:00:00.000,광주광역시,723,405,374,349,48.27
2020-10-12 00:00:00.000,제주특별자치도,533,281,270,263,49.34
2020-10-12 00:00:00.000,울산광역시,437,251,233,204,46.68
2020-10-12 00:00:00.000,세종특별자치시,300,183,162,138,46
2020-10-12 00:00:00.000,인천광역,107,83,53,54,50.47
2020-10-12 00:00:00.000,충남,78,59,43,35,44.87
2020-10-12 00:00:00.000,인천,73,58,36,37,50.68
2020-10-12 00:00:00.000,강원,48,36,20,28,58.33
2020-10-12 00:00:00.000,경북,48,34,25,23,47.92
2020-10-12 00:00:00.000,경남,46,32,22,24,52.17
2020-10-12 00:00:00.000,충북,47,27,21,26,55.32
2020-10-12 00:00:00.000,전북,34,26,17,17,50
2020-10-12 00:00:00.000,전남,42,24,24,18,42.86
2020-10-12 00:00:00.000,부산광역,37,23,15,22,59.46
2020-10-12 00:00:00.000,광주광역,31,21,16,15,48.39
2020-10-12 00:00:00.000,대전,37,20,16,21,56.76
2020-10-12 00:00:00.000,부산,23,18,15,8,34.78
2020-10-12 00:00:00.000,대구광역,21,17,15,6,28.57
2020-10-12 00:00:00.000,대전광역,24,17,10,14,58.33
2020-10-12 00:00:00.000,대구,27,14,7,20,74.07
2020-10-12 00:00:00.000,광주,24,14,10,14,58.33
2020-10-12 00:00:00.000,★★★★★★★★,18,13,7,11,61.11
2020-10-12 00:00:00.000,울,15,12,10,5,33.33
2020-10-12 00:00:00.000,울산,13,7,8,5,38.46
2020-10-12 00:00:00.000,울산광역,10,6,4,6,60
2020-10-12 00:00:00.000,기,7,4,2,5,71.43
2020-10-12 00:00:00.000,서울강북구,6,4,3,3,50
2020-10-12 00:00:00.000,제주도,6,4,1,5,83.33
2020-10-12 00:00:00.000,서울시,4,3,3,1,25
2020-10-12 00:00:00.000,남,4,3,1,3,75
2020-10-12 00:00:00.000,제주,6,3,1,5,83.33
2020-10-12 00:00:00.000,북,1,1,0,1,100
2020-10-12 00:00:00.000,강북구,1,1,1,0,0
2020-10-12 00:00:00.000,세종시,1,1,1,0,0
2020-10-12 00:00:00.000,전,4,1,0,4,100
2020-10-12 00:00:00.000,천,1,1,1,0,0
2020-10-12 00:00:00.000,산,1,1,1,0,0
2020-10-12 00:00:00.000,서울관악구봉천1동,1,1,1,0,0
2020-10-19 00:00:00.000,서울특별시,50868,32216,28320,22548,44.33
2020-10-19 00:00:00.000,경기도,18787,11745,10531,8256,43.95
2020-10-19 00:00:00.000,인천광역시,2999,1820,1699,1300,43.35
2020-10-19 00:00:00.000,서울,2478,1760,1431,1047,42.25
2020-10-19 00:00:00.000,충청남도,2225,1354,1194,1031,46.34
2020-10-19 00:00:00.000,,1497,1291,671,826,55.18
2020-10-19 00:00:00.000,경상북도,2019,1162,1056,963,47.7
2020-10-19 00:00:00.000,강원도,1911,1125,1028,883,46.21
2020-10-19 00:00:00.000,경상남도,1685,943,859,826,49.02
2020-10-19 00:00:00.000,충청북도,1547,891,828,719,46.48
2020-10-19 00:00:00.000,전라남도,1391,814,739,652,46.87
2020-10-19 00:00:00.000,전라북도,1272,773,659,613,48.19
2020-10-19 00:00:00.000,부산광역시,1383,758,697,686,49.6
2020-10-19 00:00:00.000,대전광역시,1219,674,677,542,44.46
2020-10-19 00:00:00.000,경기,767,560,426,341,44.46
2020-10-19 00:00:00.000,대구광역시,915,509,497,418,45.68
2020-10-19 00:00:00.000,광주광역시,864,480,436,428,49.54
2020-10-19 00:00:00.000,제주특별자치도,670,362,399,271,40.45
2020-10-19 00:00:00.000,울산광역시,556,313,279,277,49.82
2020-10-19 00:00:00.000,세종특별자치시,379,241,217,162,42.74
2020-10-19 00:00:00.000,인천광역,158,111,91,67,42.41
2020-10-19 00:00:00.000,인천,122,87,72,50,40.98
2020-10-19 00:00:00.000,충남,98,63,46,52,53.06
2020-10-19 00:00:00.000,강원,75,52,35,40,53.33
2020-10-19 00:00:00.000,경북,59,43,37,22,37.29
2020-10-19 00:00:00.000,경남,63,42,32,31,49.21
2020-10-19 00:00:00.000,충북,47,34,27,20,42.55
2020-10-19 00:00:00.000,전남,50,32,25,25,50
2020-10-19 00:00:00.000,부산광역,51,30,25,26,50.98
2020-10-19 00:00:00.000,대전광역,35,28,19,16,45.71
2020-10-19 00:00:00.000,전북,35,24,13,22,62.86
2020-10-19 00:00:00.000,광주광역,35,22,18,17,48.57
2020-10-19 00:00:00.000,대전,31,21,20,11,35.48
2020-10-19 00:00:00.000,부산,25,19,16,9,36
2020-10-19 00:00:00.000,★★★★★★★★,24,19,12,12,50
2020-10-19 00:00:00.000,대구,26,17,13,13,50
2020-10-19 00:00:00.000,대구광역,18,13,9,9,50
2020-10-19 00:00:00.000,광주,23,13,10,13,56.52
2020-10-19 00:00:00.000,울산,16,10,6,10,62.5
2020-10-19 00:00:00.000,제주,16,10,8,8,50
2020-10-19 00:00:00.000,제주도,11,8,4,7,63.64
2020-10-19 00:00:00.000,울,11,8,8,3,27.27
2020-10-19 00:00:00.000,울산광역,7,6,5,2,28.57
2020-10-19 00:00:00.000,서울강북구,7,6,5,2,28.57
2020-10-19 00:00:00.000,남,3,3,3,0,0
2020-10-19 00:00:00.000,기,5,3,3,2,40
2020-10-19 00:00:00.000,산,3,2,3,0,0
2020-10-19 00:00:00.000,천,2,2,1,1,50
2020-10-19 00:00:00.000,인천시,2,1,0,2,100
2020-10-19 00:00:00.000,경기용인시풍덕천2동,1,1,1,0,0
2020-10-19 00:00:00.000,북,1,1,1,0,0
2020-10-19 00:00:00.000,전,1,1,1,0,0
2020-10-19 00:00:00.000,서울시,3,1,1,2,66.67
2020-10-19 00:00:00.000,서대문구,1,1,1,0,0
2020-10-26 00:00:00.000,서울특별시,49319,31290,27469,21850,44.3
2020-10-26 00:00:00.000,경기도,18377,11438,10103,8274,45.02
2020-10-26 00:00:00.000,인천광역시,2952,1769,1618,1334,45.19
2020-10-26 00:00:00.000,서울,2364,1692,1283,1081,45.73
2020-10-26 00:00:00.000,충청남도,2160,1315,1141,1019,47.18
2020-10-26 00:00:00.000,경상북도,1995,1137,1017,978,49.02
2020-10-26 00:00:00.000,강원도,1734,1049,946,788,45.44
2020-10-26 00:00:00.000,경상남도,1555,901,794,761,48.94
2020-10-26 00:00:00.000,충청북도,1424,840,760,664,46.63
2020-10-26 00:00:00.000,,944,777,691,253,26.8
2020-10-26 00:00:00.000,전라남도,1299,761,684,615,47.34
2020-10-26 00:00:00.000,부산광역시,1340,731,683,657,49.03
2020-10-26 00:00:00.000,전라북도,1209,694,624,585,48.39
2020-10-26 00:00:00.000,대전광역시,1144,649,585,559,48.86
2020-10-26 00:00:00.000,경기,817,581,444,373,45.65
2020-10-26 00:00:00.000,대구광역시,894,505,466,428,47.87
2020-10-26 00:00:00.000,광주광역시,878,474,457,421,47.95
2020-10-26 00:00:00.000,제주특별자치도,696,353,361,335,48.13
2020-10-26 00:00:00.000,울산광역시,536,296,284,252,47.01
2020-10-26 00:00:00.000,세종특별자치시,363,222,205,158,43.53
2020-10-26 00:00:00.000,인천광역,130,94,73,57,43.85
2020-10-26 00:00:00.000,인천,80,62,45,35,43.75
2020-10-26 00:00:00.000,경남,88,61,37,51,57.95
2020-10-26 00:00:00.000,충남,95,57,42,53,55.79
2020-10-26 00:00:00.000,경북,74,48,40,34,45.95
2020-10-26 00:00:00.000,강원,67,47,32,35,52.24
2020-10-26 00:00:00.000,충북,53,37,30,23,43.4
2020-10-26 00:00:00.000,부산광역,56,30,27,29,51.79
2020-10-26 00:00:00.000,대전광역,38,28,21,17,44.74
2020-10-26 00:00:00.000,전북,37,23,24,13,35.14
2020-10-26 00:00:00.000,전남,34,22,18,16,47.06
2020-10-26 00:00:00.000,★★★★★★★★,25,22,13,12,48
2020-10-26 00:00:00.000,부산,34,21,10,24,70.59
2020-10-26 00:00:00.000,대전,24,18,11,13,54.17
2020-10-26 00:00:00.000,대구,35,18,15,20,57.14
2020-10-26 00:00:00.000,광주,26,17,16,10,38.46
2020-10-26 00:00:00.000,광주광역,27,17,15,12,44.44
2020-10-26 00:00:00.000,대구광역,26,16,12,14,53.85
2020-10-26 00:00:00.000,제주도,17,12,12,5,29.41
2020-10-26 00:00:00.000,울산,17,12,9,8,47.06
2020-10-26 00:00:00.000,서울강북구,13,11,9,4,30.77
2020-10-26 00:00:00.000,제주,14,11,8,6,42.86
2020-10-26 00:00:00.000,울산광역,13,10,8,5,38.46
2020-10-26 00:00:00.000,울,12,10,5,7,58.33
2020-10-26 00:00:00.000,강북구,3,2,1,2,66.67
2020-10-26 00:00:00.000,인헌12다길,1,1,1,0,0
2020-10-26 00:00:00.000,서울시,1,1,0,1,100
2020-10-26 00:00:00.000,기,2,1,2,0,0
2020-10-26 00:00:00.000,경기도화성시송산동,2,1,2,0,0
2020-10-26 00:00:00.000,원,2,1,0,2,100
2020-10-26 00:00:00.000,강동구,1,1,1,0,0
2020-10-26 00:00:00.000,남,1,1,1,0,0
2020-10-26 00:00:00.000,경기용인시풍덕천2동,2,1,2,0,0
2020-10-26 00:00:00.000,세종시,2,1,2,0,0
2020-10-26 00:00:00.000,산,2,1,2,0,0
2020-11-02 00:00:00.000,서울특별시,50263,31929,27919,22344,44.45
2020-11-02 00:00:00.000,경기도,18509,11538,10161,8348,45.1
2020-11-02 00:00:00.000,인천광역시,2954,1787,1604,1350,45.7
2020-11-02 00:00:00.000,서울,2477,1736,1361,1116,45.05
2020-11-02 00:00:00.000,충청남도,2135,1317,1162,973,45.57
2020-11-02 00:00:00.000,경상북도,1963,1144,1026,937,47.73
2020-11-02 00:00:00.000,강원도,1799,1065,959,840,46.69
2020-11-02 00:00:00.000,경상남도,1650,904,823,827,50.12
2020-11-02 00:00:00.000,,1078,860,762,316,29.31
2020-11-02 00:00:00.000,충청북도,1459,854,801,658,45.1
2020-11-02 00:00:00.000,전라남도,1416,791,725,691,48.8
2020-11-02 00:00:00.000,부산광역시,1325,731,699,626,47.25
2020-11-02 00:00:00.000,전라북도,1258,727,652,606,48.17
2020-11-02 00:00:00.000,대전광역시,1091,638,622,469,42.99
2020-11-02 00:00:00.000,경기,796,562,444,352,44.22
2020-11-02 00:00:00.000,대구광역시,953,525,519,434,45.54
2020-11-02 00:00:00.000,광주광역시,843,474,443,400,47.45
2020-11-02 00:00:00.000,제주특별자치도,663,357,337,326,49.17
2020-11-02 00:00:00.000,울산광역시,548,307,275,273,49.82
2020-11-02 00:00:00.000,세종특별자치시,379,217,193,186,49.08
2020-11-02 00:00:00.000,인천광역,138,101,79,59,42.75
2020-11-02 00:00:00.000,인천,107,70,54,53,49.53
2020-11-02 00:00:00.000,충남,98,61,45,53,54.08
2020-11-02 00:00:00.000,강원,79,53,36,43,54.43
2020-11-02 00:00:00.000,경북,81,52,40,41,50.62
2020-11-02 00:00:00.000,경남,69,46,34,35,50.72
2020-11-02 00:00:00.000,부산광역,58,35,28,30,51.72
2020-11-02 00:00:00.000,전북,38,31,19,19,50
2020-11-02 00:00:00.000,광주광역,35,24,19,16,45.71
2020-11-02 00:00:00.000,충북,32,23,18,14,43.75
2020-11-02 00:00:00.000,대전,39,22,16,23,58.97
2020-11-02 00:00:00.000,전남,38,21,13,25,65.79
2020-11-02 00:00:00.000,대전광역,32,21,16,16,50
2020-11-02 00:00:00.000,광주,29,21,15,14,48.28
2020-11-02 00:00:00.000,대구광역,24,16,10,14,58.33
2020-11-02 00:00:00.000,★★★★★★★★,23,16,8,15,65.22
2020-11-02 00:00:00.000,대구,23,15,13,10,43.48
2020-11-02 00:00:00.000,울산,20,14,15,5,25
2020-11-02 00:00:00.000,부산,26,14,13,13,50
2020-11-02 00:00:00.000,울,13,11,8,5,38.46
2020-11-02 00:00:00.000,제주도,12,8,5,7,58.33
2020-11-02 00:00:00.000,서울강북구,9,8,9,0,0
2020-11-02 00:00:00.000,제주,12,7,6,6,50
2020-11-02 00:00:00.000,울산광역,7,6,6,1,14.29
2020-11-02 00:00:00.000,기,5,5,3,2,40
2020-11-02 00:00:00.000,강북구,4,3,1,3,75
2020-11-02 00:00:00.000,서울시,2,2,1,1,50
2020-11-02 00:00:00.000,원,3,1,2,1,33.33
2020-11-02 00:00:00.000,서대문구,1,1,1,0,0
2020-11-02 00:00:00.000,인천시,1,1,1,0,0
2020-11-02 00:00:00.000,(주소불명)1119,2,1,1,1,50
2020-11-02 00:00:00.000,천,1,1,1,0,0
2020-11-02 00:00:00.000,산,2,1,2,0,0
2020-11-02 00:00:00.000,경남마산시해운동,3,1,2,1,33.33
2020-11-09 00:00:00.000,서울특별시,49381,31180,27206,22175,44.91
2020-11-09 00:00:00.000,경기도,18384,11398,10098,8286,45.07
2020-11-09 00:00:00.000,인천광역시,3104,1853,1646,1458,46.97
2020-11-09 00:00:00.000,서울,2376,1686,1312,1064,44.78
2020-11-09 00:00:00.000,충청남도,2170,1365,1220,950,43.78
2020-11-09 00:00:00.000,경상북도,1970,1151,1024,946,48.02
2020-11-09 00:00:00.000,강원도,1687,1025,932,755,44.75
2020-11-09 00:00:00.000,경상남도,1621,876,826,795,49.04
2020-11-09 00:00:00.000,,1083,830,712,371,34.26
2020-11-09 00:00:00.000,충청북도,1338,813,712,626,46.79
2020-11-09 00:00:00.000,전라북도,1245,732,677,568,45.62
2020-11-09 00:00:00.000,부산광역시,1340,716,696,644,48.06
2020-11-09 00:00:00.000,전라남도,1237,714,668,569,46
2020-11-09 00:00:00.000,대전광역시,1066,607,544,522,48.97
2020-11-09 00:00:00.000,경기,761,544,427,334,43.89
2020-11-09 00:00:00.000,광주광역시,804,470,414,390,48.51
2020-11-09 00:00:00.000,대구광역시,825,459,413,412,49.94
2020-11-09 00:00:00.000,제주특별자치도,666,378,368,298,44.74
2020-11-09 00:00:00.000,울산광역시,423,246,223,200,47.28
2020-11-09 00:00:00.000,세종특별자치시,352,203,185,167,47.44
2020-11-09 00:00:00.000,인천광역,118,92,62,56,47.46
2020-11-09 00:00:00.000,충남,76,57,43,33,43.42
2020-11-09 00:00:00.000,인천,82,57,44,38,46.34
2020-11-09 00:00:00.000,강원,78,47,36,42,53.85
2020-11-09 00:00:00.000,경북,78,45,40,38,48.72
2020-11-09 00:00:00.000,경남,67,41,34,33,49.25
2020-11-09 00:00:00.000,충북,53,37,31,22,41.51
2020-11-09 00:00:00.000,전북,50,34,23,27,54
2020-11-09 00:00:00.000,대구광역,35,26,17,18,51.43
2020-11-09 00:00:00.000,부산,35,24,16,19,54.29
2020-11-09 00:00:00.000,부산광역,39,24,20,19,48.72
2020-11-09 00:00:00.000,대전광역,44,23,19,25,56.82
2020-11-09 00:00:00.000,전남,34,23,19,15,44.12
2020-11-09 00:00:00.000,★★★★★★★★,33,21,14,19,57.58
2020-11-09 00:00:00.000,광주,31,20,17,14,45.16
2020-11-09 00:00:00.000,대구,27,18,14,13,48.15
2020-11-09 00:00:00.000,대전,25,14,9,16,64
2020-11-09 00:00:00.000,광주광역,19,14,16,3,15.79
2020-11-09 00:00:00.000,제주도,17,12,10,7,41.18
2020-11-09 00:00:00.000,제주,18,11,9,9,50
2020-11-09 00:00:00.000,서울강북구,14,9,3,11,78.57
2020-11-09 00:00:00.000,울산광역,13,8,4,9,69.23
2020-11-09 00:00:00.000,울,8,7,6,2,25
2020-11-09 00:00:00.000,기,6,5,3,3,50
2020-11-09 00:00:00.000,울산,10,5,2,8,80
2020-11-09 00:00:00.000,서울시,3,3,2,1,33.33
2020-11-09 00:00:00.000,원,1,1,1,0,0
2020-11-09 00:00:00.000,충부,2,1,0,2,100
2020-11-09 00:00:00.000,(주소불명)1119,1,1,0,1,100
2020-11-09 00:00:00.000,남동구만수2동,2,1,0,2,100
2020-11-09 00:00:00.000,경기도양주군회천읍,1,1,1,0,0
2020-11-09 00:00:00.000,남,4,1,0,4,100
2020-11-09 00:00:00.000,세종시,2,1,0,2,100
2020-11-09 00:00:00.000,서울관악구봉천1동,1,1,1,0,0
2020-11-09 00:00:00.000,전,1,1,1,0,0
2020-11-16 00:00:00.000,서울특별시,48672,31072,27307,21365,43.9
2020-11-16 00:00:00.000,경기도,18392,11438,10116,8276,45
2020-11-16 00:00:00.000,인천광역시,3059,1879,1739,1320,43.15
2020-11-16 00:00:00.000,서울,2370,1695,1341,1029,43.42
2020-11-16 00:00:00.000,충청남도,2001,1227,1092,909,45.43
2020-11-16 00:00:00.000,경상북도,1923,1132,985,938,48.78
2020-11-16 00:00:00.000,강원도,1700,983,878,822,48.35
2020-11-16 00:00:00.000,경상남도,1532,860,803,729,47.58
2020-11-16 00:00:00.000,충청북도,1367,818,748,619,45.28
2020-11-16 00:00:00.000,,974,756,650,324,33.26
2020-11-16 00:00:00.000,전라북도,1278,729,639,639,50
2020-11-16 00:00:00.000,전라남도,1233,705,650,583,47.28
2020-11-16 00:00:00.000,부산광역시,1302,691,649,653,50.15
2020-11-16 00:00:00.000,대전광역시,1148,650,639,509,44.34
2020-11-16 00:00:00.000,경기,780,520,403,377,48.33
2020-11-16 00:00:00.000,대구광역시,889,512,456,433,48.71
2020-11-16 00:00:00.000,광주광역시,789,456,391,398,50.44
2020-11-16 00:00:00.000,제주특별자치도,724,376,383,341,47.1
2020-11-16 00:00:00.000,울산광역시,605,335,329,276,45.62
2020-11-16 00:00:00.000,세종특별자치시,371,218,191,180,48.52
2020-11-16 00:00:00.000,인천광역,131,89,71,60,45.8
2020-11-16 00:00:00.000,인천,89,63,44,45,50.56
2020-11-16 00:00:00.000,충남,87,60,44,43,49.43
2020-11-16 00:00:00.000,경북,79,56,40,39,49.37
2020-11-16 00:00:00.000,충북,68,47,34,34,50
2020-11-16 00:00:00.000,강원,66,43,31,35,53.03
2020-11-16 00:00:00.000,경남,47,34,25,22,46.81
2020-11-16 00:00:00.000,부산광역,39,29,24,15,38.46
2020-11-16 00:00:00.000,전북,54,28,24,30,55.56
2020-11-16 00:00:00.000,전남,56,27,21,35,62.5
2020-11-16 00:00:00.000,대전,38,24,21,17,44.74
2020-11-16 00:00:00.000,광주,33,23,23,10,30.3
2020-11-16 00:00:00.000,부산,38,21,12,26,68.42
2020-11-16 00:00:00.000,대전광역,28,18,11,17,60.71
2020-11-16 00:00:00.000,★★★★★★★★,30,18,9,21,70
2020-11-16 00:00:00.000,대구광역,25,15,11,14,56
2020-11-16 00:00:00.000,제주도,22,12,12,10,45.45
2020-11-16 00:00:00.000,광주광역,14,12,11,3,21.43
2020-11-16 00:00:00.000,대구,16,11,6,10,62.5
2020-11-16 00:00:00.000,울산,22,11,13,9,40.91
2020-11-16 00:00:00.000,서울강북구,14,10,10,4,28.57
2020-11-16 00:00:00.000,제주,11,10,7,4,36.36
2020-11-16 00:00:00.000,울산광역,17,10,6,11,64.71
2020-11-16 00:00:00.000,울,8,5,3,5,62.5
2020-11-16 00:00:00.000,기,5,4,3,2,40
2020-11-16 00:00:00.000,남,4,2,2,2,50
2020-11-16 00:00:00.000,서울시,3,2,1,2,66.67
2020-11-16 00:00:00.000,산,2,1,2,0,0
2020-11-16 00:00:00.000,인천직할시,2,1,1,1,50
2020-11-16 00:00:00.000,충부,2,1,2,0,0
2020-11-16 00:00:00.000,부산시,1,1,1,0,0
2020-11-16 00:00:00.000,주,1,1,1,0,0
2020-11-16 00:00:00.000,남동구만수2동,2,1,0,2,100
2020-11-16 00:00:00.000,전남여수시여서동,2,1,1,1,50
2020-11-16 00:00:00.000,강북구,1,1,1,0,0
2020-11-23 00:00:00.000,서울특별시,49035,31060,27460,21575,44
2020-11-23 00:00:00.000,경기도,18399,11465,10176,8223,44.69
2020-11-23 00:00:00.000,인천광역시,3147,1871,1696,1451,46.11
2020-11-23 00:00:00.000,서울,2274,1606,1271,1003,44.11
2020-11-23 00:00:00.000,충청남도,2169,1305,1185,984,45.37
2020-11-23 00:00:00.000,경상북도,2010,1157,1052,958,47.66
2020-11-23 00:00:00.000,강원도,1756,1050,964,792,45.1
2020-11-23 00:00:00.000,경상남도,1525,880,768,757,49.64
2020-11-23 00:00:00.000,충청북도,1379,804,760,619,44.89
2020-11-23 00:00:00.000,,950,774,691,259,27.26
2020-11-23 00:00:00.000,전라북도,1320,737,706,614,46.52
2020-11-23 00:00:00.000,전라남도,1296,730,650,646,49.85
2020-11-23 00:00:00.000,부산광역시,1254,661,630,624,49.76
2020-11-23 00:00:00.000,대전광역시,1179,643,646,533,45.21
2020-11-23 00:00:00.000,대구광역시,951,534,511,440,46.27
2020-11-23 00:00:00.000,경기,745,509,416,329,44.16
2020-11-23 00:00:00.000,광주광역시,848,461,452,396,46.7
2020-11-23 00:00:00.000,제주특별자치도,593,327,324,269,45.36
2020-11-23 00:00:00.000,울산광역시,475,268,259,216,45.47
2020-11-23 00:00:00.000,세종특별자치시,348,203,195,153,43.97
2020-11-23 00:00:00.000,인천광역,122,91,72,50,40.98
2020-11-23 00:00:00.000,인천,105,72,70,35,33.33
2020-11-23 00:00:00.000,충남,98,64,44,54,55.1
2020-11-23 00:00:00.000,강원,66,50,39,27,40.91
2020-11-23 00:00:00.000,경북,69,45,36,33,47.83
2020-11-23 00:00:00.000,전북,56,36,41,15,26.79
2020-11-23 00:00:00.000,충북,47,34,19,28,59.57
2020-11-23 00:00:00.000,전남,47,29,31,16,34.04
2020-11-23 00:00:00.000,대전광역,38,29,19,19,50
2020-11-23 00:00:00.000,경남,43,24,16,27,62.79
2020-11-23 00:00:00.000,부산광역,32,21,15,17,53.13
2020-11-23 00:00:00.000,대구광역,32,20,14,18,56.25
2020-11-23 00:00:00.000,광주광역,25,20,19,6,24
2020-11-23 00:00:00.000,대전,26,20,13,13,50
2020-11-23 00:00:00.000,부산,28,19,16,12,42.86
2020-11-23 00:00:00.000,광주,24,18,13,11,45.83
2020-11-23 00:00:00.000,★★★★★★★★,18,14,6,12,66.67
2020-11-23 00:00:00.000,제주도,21,11,9,12,57.14
2020-11-23 00:00:00.000,울산광역,16,11,13,3,18.75
2020-11-23 00:00:00.000,울산,21,10,6,15,71.43
2020-11-23 00:00:00.000,서울강북구,12,10,9,3,25
2020-11-23 00:00:00.000,대구,10,9,7,3,30
2020-11-23 00:00:00.000,울,9,7,4,5,55.56
2020-11-23 00:00:00.000,제주,6,6,5,1,16.67
2020-11-23 00:00:00.000,기,6,6,5,1,16.67
2020-11-23 00:00:00.000,남동구만수2동,2,2,2,0,0
2020-11-23 00:00:00.000,산,2,1,0,2,100
2020-11-23 00:00:00.000,서울시,1,1,0,1,100
2020-11-23 00:00:00.000,서대문구,1,1,0,1,100
2020-11-23 00:00:00.000,서울관악구봉천1동,1,1,1,0,0
2020-11-23 00:00:00.000,인천직할시,1,1,1,0,0
2020-11-30 00:00:00.000,서울특별시,49114,31169,27581,21533,43.84
2020-11-30 00:00:00.000,경기도,17911,11200,10027,7884,44.02
2020-11-30 00:00:00.000,인천광역시,3069,1828,1673,1396,45.49
2020-11-30 00:00:00.000,서울,2316,1685,1359,957,41.32
2020-11-30 00:00:00.000,충청남도,2085,1275,1168,917,43.98
2020-11-30 00:00:00.000,경상북도,1867,1051,993,874,46.81
2020-11-30 00:00:00.000,강원도,1724,983,943,781,45.3
2020-11-30 00:00:00.000,,1176,876,778,398,33.84
2020-11-30 00:00:00.000,경상남도,1531,820,777,754,49.25
2020-11-30 00:00:00.000,충청북도,1296,760,687,609,46.99
2020-11-30 00:00:00.000,전라남도,1199,690,606,593,49.46
2020-11-30 00:00:00.000,전라북도,1190,658,608,582,48.91
2020-11-30 00:00:00.000,대전광역시,1054,604,548,506,48.01
2020-11-30 00:00:00.000,부산광역시,1131,598,530,601,53.14
2020-11-30 00:00:00.000,경기,762,527,416,346,45.41
2020-11-30 00:00:00.000,대구광역시,837,489,478,359,42.89
2020-11-30 00:00:00.000,광주광역시,803,408,406,397,49.44
2020-11-30 00:00:00.000,제주특별자치도,603,311,314,289,47.93
2020-11-30 00:00:00.000,울산광역시,437,254,233,204,46.68
2020-11-30 00:00:00.000,세종특별자치시,365,220,180,185,50.68
2020-11-30 00:00:00.000,인천광역,107,78,65,42,39.25
2020-11-30 00:00:00.000,인천,83,65,60,23,27.71
2020-11-30 00:00:00.000,충남,67,51,41,26,38.81
2020-11-30 00:00:00.000,경북,83,48,41,42,50.6
2020-11-30 00:00:00.000,충북,51,35,30,21,41.18
2020-11-30 00:00:00.000,경남,59,34,32,27,45.76
2020-11-30 00:00:00.000,강원,50,32,24,26,52
2020-11-30 00:00:00.000,광주광역,38,25,24,14,36.84
2020-11-30 00:00:00.000,부산광역,34,22,14,20,58.82
2020-11-30 00:00:00.000,부산,38,21,22,16,42.11
2020-11-30 00:00:00.000,전북,36,21,22,14,38.89
2020-11-30 00:00:00.000,대전,30,20,14,16,53.33
2020-11-30 00:00:00.000,★★★★★★★★,28,18,10,18,64.29
2020-11-30 00:00:00.000,전남,30,18,18,12,40
2020-11-30 00:00:00.000,대전광역,24,17,14,10,41.67
2020-11-30 00:00:00.000,울산,29,14,14,15,51.72
2020-11-30 00:00:00.000,광주,19,14,11,8,42.11
2020-11-30 00:00:00.000,울,8,8,8,0,0
2020-11-30 00:00:00.000,대구,12,8,6,6,50
2020-11-30 00:00:00.000,대구광역,9,8,6,3,33.33
2020-11-30 00:00:00.000,울산광역,10,7,5,5,50
2020-11-30 00:00:00.000,서울강북구,10,7,5,5,50
2020-11-30 00:00:00.000,제주,12,7,8,4,33.33
2020-11-30 00:00:00.000,제주도,13,6,4,9,69.23
2020-11-30 00:00:00.000,남,6,4,4,2,33.33
2020-11-30 00:00:00.000,기,3,2,1,2,66.67
2020-11-30 00:00:00.000,서구,2,1,1,1,50
2020-11-30 00:00:00.000,경기도화성시송산동,2,1,1,1,50
2020-11-30 00:00:00.000,서울시,1,1,0,1,100
2020-11-30 00:00:00.000,세종시,1,1,1,0,0
2020-12-07 00:00:00.000,서울특별시,50051,31570,27982,22069,44.09
2020-12-07 00:00:00.000,경기도,18451,11536,10194,8257,44.75
2020-12-07 00:00:00.000,인천광역시,3157,1870,1781,1376,43.59
2020-12-07 00:00:00.000,서울,2523,1781,1449,1074,42.57
2020-12-07 00:00:00.000,충청남도,2143,1283,1164,979,45.68
2020-12-07 00:00:00.000,경상북도,1980,1105,979,1001,50.56
2020-12-07 00:00:00.000,강원도,1774,1030,946,828,46.67
2020-12-07 00:00:00.000,경상남도,1508,835,749,759,50.33
2020-12-07 00:00:00.000,충청북도,1299,753,739,560,43.11
2020-12-07 00:00:00.000,,992,751,626,366,36.9
2020-12-07 00:00:00.000,전라남도,1200,698,617,583,48.58
2020-12-07 00:00:00.000,부산광역시,1197,650,631,566,47.28
2020-12-07 00:00:00.000,전라북도,1111,645,569,542,48.78
2020-12-07 00:00:00.000,대전광역시,1142,633,618,524,45.88
2020-12-07 00:00:00.000,경기,803,566,430,373,46.45
2020-12-07 00:00:00.000,대구광역시,818,459,402,416,50.86
2020-12-07 00:00:00.000,광주광역시,805,434,408,397,49.32
2020-12-07 00:00:00.000,제주특별자치도,598,342,323,275,45.99
2020-12-07 00:00:00.000,울산광역시,436,268,232,204,46.79
2020-12-07 00:00:00.000,세종특별자치시,367,222,198,169,46.05
2020-12-07 00:00:00.000,인천광역,117,84,56,61,52.14
2020-12-07 00:00:00.000,충남,83,56,44,39,46.99
2020-12-07 00:00:00.000,인천,72,54,44,28,38.89
2020-12-07 00:00:00.000,경북,81,51,38,43,53.09
2020-12-07 00:00:00.000,경남,59,39,27,32,54.24
2020-12-07 00:00:00.000,충북,64,37,28,36,56.25
2020-12-07 00:00:00.000,강원,42,35,21,21,50
2020-12-07 00:00:00.000,전북,44,28,20,24,54.55
2020-12-07 00:00:00.000,부산광역,36,26,19,17,47.22
2020-12-07 00:00:00.000,광주광역,41,25,18,23,56.1
2020-12-07 00:00:00.000,★★★★★★★★,33,25,17,16,48.48
2020-12-07 00:00:00.000,대전,29,23,12,17,58.62
2020-12-07 00:00:00.000,대전광역,30,21,18,12,40
2020-12-07 00:00:00.000,전남,32,21,20,12,37.5
2020-12-07 00:00:00.000,부산,22,15,12,10,45.45
2020-12-07 00:00:00.000,광주,22,14,12,10,45.45
2020-12-07 00:00:00.000,대구,18,13,10,8,44.44
2020-12-07 00:00:00.000,대구광역,14,11,6,8,57.14
2020-12-07 00:00:00.000,울,13,10,7,6,46.15
2020-12-07 00:00:00.000,울산,17,9,5,12,70.59
2020-12-07 00:00:00.000,제주도,10,8,7,3,30
2020-12-07 00:00:00.000,서울강북구,7,6,6,1,14.29
2020-12-07 00:00:00.000,기,5,4,1,4,80
2020-12-07 00:00:00.000,제주,7,4,6,1,14.29
2020-12-07 00:00:00.000,서울시,4,3,1,3,75
2020-12-07 00:00:00.000,울산광역,4,3,1,3,75
2020-12-07 00:00:00.000,대정광역,1,1,1,0,0
2020-12-07 00:00:00.000,광주시,2,1,0,2,100
2020-12-07 00:00:00.000,서울관악구봉천1동,1,1,1,0,0
2020-12-07 00:00:00.000,북,2,1,0,2,100
2020-12-07 00:00:00.000,경기도화성시송산동,1,1,1,0,0
2020-12-07 00:00:00.000,서초구,1,1,1,0,0
2020-12-14 00:00:00.000,서울특별시,50533,30992,28693,21840,43.22
2020-12-14 00:00:00.000,경기도,18532,11396,10090,8442,45.55
2020-12-14 00:00:00.000,인천광역시,3041,1854,1695,1346,44.26
2020-12-14 00:00:00.000,서울,2240,1620,1287,953,42.54
2020-12-14 00:00:00.000,충청남도,2202,1327,1199,1003,45.55
2020-12-14 00:00:00.000,경상북도,1892,1070,933,959,50.69
2020-12-14 00:00:00.000,강원도,1746,1002,901,845,48.4
2020-12-14 00:00:00.000,경상남도,1582,818,772,810,51.2
2020-12-14 00:00:00.000,충청북도,1411,789,786,625,44.29
2020-12-14 00:00:00.000,,950,737,649,301,31.68
2020-12-14 00:00:00.000,전라남도,1310,702,661,649,49.54
2020-12-14 00:00:00.000,전라북도,1222,673,616,606,49.59
2020-12-14 00:00:00.000,대전광역시,1154,641,575,579,50.17
2020-12-14 00:00:00.000,부산광역시,1194,623,619,575,48.16
2020-12-14 00:00:00.000,경기,740,520,396,344,46.49
2020-12-14 00:00:00.000,대구광역시,866,476,428,438,50.58
2020-12-14 00:00:00.000,광주광역시,812,458,415,397,48.89
2020-12-14 00:00:00.000,제주특별자치도,624,324,326,298,47.76
2020-12-14 00:00:00.000,울산광역시,379,204,213,166,43.8
2020-12-14 00:00:00.000,세종특별자치시,339,192,159,180,53.1
2020-12-14 00:00:00.000,인천광역,95,69,59,36,37.89
2020-12-14 00:00:00.000,인천,105,66,52,53,50.48
2020-12-14 00:00:00.000,충남,80,56,43,37,46.25
2020-12-14 00:00:00.000,경북,68,44,32,36,52.94
2020-12-14 00:00:00.000,충북,57,38,28,29,50.88
2020-12-14 00:00:00.000,경남,56,32,20,36,64.29
2020-12-14 00:00:00.000,강원,62,32,22,40,64.52
2020-12-14 00:00:00.000,대전광역,34,24,19,15,44.12
2020-12-14 00:00:00.000,부산광역,33,23,15,18,54.55
2020-12-14 00:00:00.000,전북,35,23,17,18,51.43
2020-12-14 00:00:00.000,광주광역,31,22,19,12,38.71
2020-12-14 00:00:00.000,부산,32,17,13,19,59.38
2020-12-14 00:00:00.000,대전,24,17,8,16,66.67
2020-12-14 00:00:00.000,★★★★★★★★,20,16,5,15,75
2020-12-14 00:00:00.000,대구광역,23,15,11,12,52.17
2020-12-14 00:00:00.000,광주,26,15,10,16,61.54
2020-12-14 00:00:00.000,전남,29,13,17,12,41.38
2020-12-14 00:00:00.000,울,14,9,6,8,57.14
2020-12-14 00:00:00.000,울산,9,9,6,3,33.33
2020-12-14 00:00:00.000,울산광역,10,7,1,9,90
2020-12-14 00:00:00.000,대구,14,7,5,9,64.29
2020-12-14 00:00:00.000,서울강북구,10,7,5,5,50
2020-12-14 00:00:00.000,제주도,9,6,2,7,77.78
2020-12-14 00:00:00.000,제주,10,4,1,9,90
2020-12-14 00:00:00.000,남,6,3,4,2,33.33
2020-12-14 00:00:00.000,기,2,2,2,0,0
2020-12-14 00:00:00.000,서울시,2,2,1,1,50
2020-12-14 00:00:00.000,산,4,2,4,0,0
2020-12-14 00:00:00.000,전,2,1,0,2,100
2020-12-14 00:00:00.000,강서구,1,1,1,0,0
2020-12-14 00:00:00.000,대동@,2,1,1,1,50
2020-12-14 00:00:00.000,원주시,1,1,0,1,100
2020-12-14 00:00:00.000,경기도화성시송산동,1,1,1,0,0
2020-12-14 00:00:00.000,경기의왕시포일동,1,1,1,0,0
2020-12-14 00:00:00.000,광주시,1,1,1,0,0
2020-12-21 00:00:00.000,서울특별시,41925,26526,24049,17876,42.64
2020-12-21 00:00:00.000,경기도,15003,9473,8449,6554,43.68
2020-12-21 00:00:00.000,인천광역시,2508,1494,1379,1129,45.02
2020-12-21 00:00:00.000,서울,1852,1340,1107,745,40.23
2020-12-21 00:00:00.000,충청남도,1712,1058,935,777,45.39
2020-12-21 00:00:00.000,경상북도,1616,903,868,748,46.29
2020-12-21 00:00:00.000,강원도,1366,802,737,629,46.05
2020-12-21 00:00:00.000,경상남도,1213,685,614,599,49.38
2020-12-21 00:00:00.000,충청북도,1113,657,629,484,43.49
2020-12-21 00:00:00.000,,834,647,526,308,36.93
2020-12-21 00:00:00.000,전라남도,1018,598,516,502,49.31
2020-12-21 00:00:00.000,부산광역시,974,538,483,491,50.41
2020-12-21 00:00:00.000,대전광역시,887,537,471,416,46.9
2020-12-21 00:00:00.000,전라북도,956,533,474,482,50.42
2020-12-21 00:00:00.000,경기,650,457,364,286,44
2020-12-21 00:00:00.000,대구광역시,657,374,340,317,48.25
2020-12-21 00:00:00.000,광주광역시,647,368,320,327,50.54
2020-12-21 00:00:00.000,제주특별자치도,511,254,243,268,52.45
2020-12-21 00:00:00.000,울산광역시,377,212,192,185,49.07
2020-12-21 00:00:00.000,세종특별자치시,270,167,150,120,44.44
2020-12-21 00:00:00.000,인천,68,56,45,23,33.82
2020-12-21 00:00:00.000,충남,85,55,49,36,42.35
2020-12-21 00:00:00.000,인천광역,82,55,37,45,54.88
2020-12-21 00:00:00.000,강원,46,33,25,21,45.65
2020-12-21 00:00:00.000,경북,45,31,23,22,48.89
2020-12-21 00:00:00.000,경남,45,31,25,20,44.44
2020-12-21 00:00:00.000,★★★★★★★★,30,25,14,16,53.33
2020-12-21 00:00:00.000,충북,27,21,17,10,37.04
2020-12-21 00:00:00.000,광주,29,18,15,14,48.28
2020-12-21 00:00:00.000,부산광역,29,18,15,14,48.28
2020-12-21 00:00:00.000,대전,22,16,7,15,68.18
2020-12-21 00:00:00.000,전북,21,15,10,11,52.38
2020-12-21 00:00:00.000,광주광역,17,15,11,6,35.29
2020-12-21 00:00:00.000,전남,29,15,12,17,58.62
2020-12-21 00:00:00.000,대구,18,14,10,8,44.44
2020-12-21 00:00:00.000,부산,19,13,8,11,57.89
2020-12-21 00:00:00.000,대전광역,19,13,10,9,47.37
2020-12-21 00:00:00.000,대구광역,14,10,7,7,50
2020-12-21 00:00:00.000,울산광역,11,8,7,4,36.36
2020-12-21 00:00:00.000,울산,10,7,2,8,80
2020-12-21 00:00:00.000,제주,12,7,6,6,50
2020-12-21 00:00:00.000,서울강북구,6,5,4,2,33.33
2020-12-21 00:00:00.000,울,7,5,4,3,42.86
2020-12-21 00:00:00.000,제주도,5,4,2,3,60
2020-12-21 00:00:00.000,기,2,2,2,0,0
2020-12-21 00:00:00.000,남,3,2,2,1,33.33
2020-12-21 00:00:00.000,서울시,4,2,2,2,50
2020-12-21 00:00:00.000,대동@,3,1,1,2,66.67
2020-12-21 00:00:00.000,강북구,3,1,2,1,33.33
2020-12-21 00:00:00.000,경기용인시풍덕천2동,1,1,1,0,0
2020-12-21 00:00:00.000,전,1,1,1,0,0
2020-12-21 00:00:00.000,부산시,1,1,1,0,0
2020-12-21 00:00:00.000,산,2,1,1,1,50
2020-12-28 00:00:00.000,서울특별시,38949,24444,21145,17804,45.71
2020-12-28 00:00:00.000,경기도,14203,8918,7550,6653,46.84
2020-12-28 00:00:00.000,인천광역시,2320,1410,1233,1087,46.85
2020-12-28 00:00:00.000,서울,1638,1164,897,741,45.24
2020-12-28 00:00:00.000,충청남도,1537,955,806,731,47.56
2020-12-28 00:00:00.000,경상북도,1391,797,680,711,51.11
2020-12-28 00:00:00.000,강원도,1289,765,638,651,50.5
2020-12-28 00:00:00.000,충청북도,1133,629,540,593,52.34
2020-12-28 00:00:00.000,,785,622,567,218,27.77
2020-12-28 00:00:00.000,경상남도,1062,613,505,557,52.45
2020-12-28 00:00:00.000,전라남도,893,511,403,490,54.87
2020-12-28 00:00:00.000,전라북도,853,510,438,415,48.65
2020-12-28 00:00:00.000,부산광역시,899,490,404,495,55.06
2020-12-28 00:00:00.000,대전광역시,730,440,382,348,47.67
2020-12-28 00:00:00.000,경기,551,383,293,258,46.82
2020-12-28 00:00:00.000,광주광역시,638,349,295,343,53.76
2020-12-28 00:00:00.000,대구광역시,583,332,265,318,54.55
2020-12-28 00:00:00.000,제주특별자치도,453,239,197,256,56.51
2020-12-28 00:00:00.000,울산광역시,315,179,142,173,54.92
2020-12-28 00:00:00.000,세종특별자치시,258,154,128,130,50.39
2020-12-28 00:00:00.000,인천광역,72,52,44,28,38.89
2020-12-28 00:00:00.000,충남,54,38,20,34,62.96
2020-12-28 00:00:00.000,인천,50,37,26,24,48
2020-12-28 00:00:00.000,경남,47,27,19,28,59.57
2020-12-28 00:00:00.000,대전광역,29,23,15,14,48.28
2020-12-28 00:00:00.000,경북,29,20,13,16,55.17
2020-12-28 00:00:00.000,강원,28,18,10,18,64.29
2020-12-28 00:00:00.000,충북,24,17,8,16,66.67
2020-12-28 00:00:00.000,★★★★★★★★,18,16,7,11,61.11
2020-12-28 00:00:00.000,전북,31,16,11,20,64.52
2020-12-28 00:00:00.000,부산광역,23,16,12,11,47.83
2020-12-28 00:00:00.000,광주광역,23,14,9,14,60.87
2020-12-28 00:00:00.000,대전,22,14,10,12,54.55
2020-12-28 00:00:00.000,광주,19,12,9,10,52.63
2020-12-28 00:00:00.000,전남,30,12,15,15,50
2020-12-28 00:00:00.000,대구,19,11,5,14,73.68
2020-12-28 00:00:00.000,부산,12,10,6,6,50
2020-12-28 00:00:00.000,대구광역,16,10,9,7,43.75
2020-12-28 00:00:00.000,서울강북구,10,8,6,4,40
2020-12-28 00:00:00.000,울산,13,7,5,8,61.54
2020-12-28 00:00:00.000,울,7,7,6,1,14.29
2020-12-28 00:00:00.000,울산광역,9,7,4,5,55.56
2020-12-28 00:00:00.000,제주,14,6,5,9,64.29
2020-12-28 00:00:00.000,기,9,6,3,6,66.67
2020-12-28 00:00:00.000,제주도,5,5,2,3,60
2020-12-28 00:00:00.000,서울시,3,2,1,2,66.67
2020-12-28 00:00:00.000,남,3,2,0,3,100
2020-12-28 00:00:00.000,대동@,1,1,1,0,0
2020-12-28 00:00:00.000,북,1,1,1,0,0
2020-12-28 00:00:00.000,천,1,1,1,0,0
2020-12-28 00:00:00.000,산,3,1,2,1,33.33
2020-12-28 00:00:00.000,강북구,1,1,1,0,0
2021-01-04 00:00:00.000,서울특별시,50079,30971,27417,22662,45.25
2021-01-04 00:00:00.000,경기도,18027,11122,9745,8282,45.94
2021-01-04 00:00:00.000,인천광역시,2993,1780,1625,1368,45.71
2021-01-04 00:00:00.000,서울,2361,1649,1284,1077,45.62
2021-01-04 00:00:00.000,충청남도,2076,1236,1095,981,47.25
2021-01-04 00:00:00.000,강원도,1763,1051,905,858,48.67
2021-01-04 00:00:00.000,경상북도,1790,995,886,904,50.5
2021-01-04 00:00:00.000,경상남도,1572,842,775,797,50.7
2021-01-04 00:00:00.000,,1056,807,656,400,37.88
2021-01-04 00:00:00.000,충청북도,1395,783,740,655,46.95
2021-01-04 00:00:00.000,전라북도,1218,685,602,616,50.57
2021-01-04 00:00:00.000,전라남도,1190,669,591,599,50.34
2021-01-04 00:00:00.000,부산광역시,1246,646,629,617,49.52
2021-01-04 00:00:00.000,대전광역시,1109,612,534,575,51.85
2021-01-04 00:00:00.000,경기,828,563,411,417,50.36
2021-01-04 00:00:00.000,대구광역시,798,460,393,405,50.75
2021-01-04 00:00:00.000,광주광역시,863,442,419,444,51.45
2021-01-04 00:00:00.000,울산광역시,546,295,265,281,51.47
2021-01-04 00:00:00.000,제주특별자치도,568,285,242,326,57.39
2021-01-04 00:00:00.000,세종특별자치시,374,215,189,185,49.47
2021-01-04 00:00:00.000,인천광역,117,81,61,56,47.86
2021-01-04 00:00:00.000,인천,85,56,44,41,48.24
2021-01-04 00:00:00.000,충남,63,42,33,30,47.62
2021-01-04 00:00:00.000,강원,68,38,21,47,69.12
2021-01-04 00:00:00.000,경북,58,36,30,28,48.28
2021-01-04 00:00:00.000,전북,53,31,20,33,62.26
2021-01-04 00:00:00.000,광주광역,36,26,15,21,58.33
2021-01-04 00:00:00.000,충북,38,25,14,24,63.16
2021-01-04 00:00:00.000,경남,37,25,17,20,54.05
2021-01-04 00:00:00.000,부산광역,38,23,18,20,52.63
2021-01-04 00:00:00.000,대전광역,32,18,16,16,50
2021-01-04 00:00:00.000,광주,22,18,15,7,31.82
2021-01-04 00:00:00.000,대전,29,18,16,13,44.83
2021-01-04 00:00:00.000,전남,29,17,15,14,48.28
2021-01-04 00:00:00.000,부산,20,15,12,8,40
2021-01-04 00:00:00.000,대구,18,14,10,8,44.44
2021-01-04 00:00:00.000,대구광역,17,12,8,9,52.94
2021-01-04 00:00:00.000,울산광역,15,12,9,6,40
2021-01-04 00:00:00.000,제주도,19,12,5,14,73.68
2021-01-04 00:00:00.000,★★★★★★★★,15,11,10,5,33.33
2021-01-04 00:00:00.000,서울강북구,20,10,9,11,55
2021-01-04 00:00:00.000,울,9,9,6,3,33.33
2021-01-04 00:00:00.000,제주,17,9,5,12,70.59
2021-01-04 00:00:00.000,울산,12,7,7,5,41.67
2021-01-04 00:00:00.000,남,4,3,3,1,25
2021-01-04 00:00:00.000,기,3,3,3,0,0
2021-01-04 00:00:00.000,원,1,1,0,1,100
2021-01-04 00:00:00.000,서울시,1,1,0,1,100
2021-01-04 00:00:00.000,강북구,1,1,1,0,0
2021-01-04 00:00:00.000,경기용인시풍덕천2동,2,1,1,1,50
2021-01-11 00:00:00.000,서울특별시,49218,30800,27652,21566,43.82
2021-01-11 00:00:00.000,경기도,18144,11164,9902,8242,45.43
2021-01-11 00:00:00.000,인천광역시,3195,1853,1717,1478,46.26
2021-01-11 00:00:00.000,서울,2380,1637,1352,1028,43.19
2021-01-11 00:00:00.000,충청남도,2191,1304,1225,966,44.09
2021-01-11 00:00:00.000,경상북도,1897,1064,966,931,49.08
2021-01-11 00:00:00.000,강원도,1763,1016,935,828,46.97
2021-01-11 00:00:00.000,경상남도,1601,870,787,814,50.84
2021-01-11 00:00:00.000,충청북도,1401,812,760,641,45.75
2021-01-11 00:00:00.000,,1017,783,665,352,34.61
2021-01-11 00:00:00.000,전라북도,1289,714,641,648,50.27
2021-01-11 00:00:00.000,전라남도,1302,711,622,680,52.23
2021-01-11 00:00:00.000,부산광역시,1285,666,651,634,49.34
2021-01-11 00:00:00.000,대전광역시,1133,643,620,513,45.28
2021-01-11 00:00:00.000,경기,853,568,465,388,45.49
2021-01-11 00:00:00.000,광주광역시,831,491,440,391,47.05
2021-01-11 00:00:00.000,대구광역시,842,476,452,390,46.32
2021-01-11 00:00:00.000,제주특별자치도,738,378,392,346,46.88
2021-01-11 00:00:00.000,울산광역시,468,269,222,246,52.56
2021-01-11 00:00:00.000,세종특별자치시,360,215,197,163,45.28
2021-01-11 00:00:00.000,인천광역,144,94,79,65,45.14
2021-01-11 00:00:00.000,인천,101,74,60,41,40.59
2021-01-11 00:00:00.000,경북,82,49,36,46,56.1
2021-01-11 00:00:00.000,충남,77,48,42,35,45.45
2021-01-11 00:00:00.000,강원,74,48,47,27,36.49
2021-01-11 00:00:00.000,경남,63,40,31,32,50.79
2021-01-11 00:00:00.000,충북,49,33,24,25,51.02
2021-01-11 00:00:00.000,전북,47,31,25,22,46.81
2021-01-11 00:00:00.000,부산광역,37,25,16,21,56.76
2021-01-11 00:00:00.000,전남,40,24,17,23,57.5
2021-01-11 00:00:00.000,대전광역,32,24,20,12,37.5
2021-01-11 00:00:00.000,광주,34,21,15,19,55.88
2021-01-11 00:00:00.000,광주광역,25,20,18,7,28
2021-01-11 00:00:00.000,대전,30,20,11,19,63.33
2021-01-11 00:00:00.000,대구광역,19,14,11,8,42.11
2021-01-11 00:00:00.000,★★★★★★★★,16,11,8,8,50
2021-01-11 00:00:00.000,울산광역,16,11,8,8,50
2021-01-11 00:00:00.000,부산,17,10,5,12,70.59
2021-01-11 00:00:00.000,대구,13,9,7,6,46.15
2021-01-11 00:00:00.000,제주,19,9,6,13,68.42
2021-01-11 00:00:00.000,제주도,16,8,8,8,50
2021-01-11 00:00:00.000,울산,11,7,5,6,54.55
2021-01-11 00:00:00.000,울,8,6,5,3,37.5
2021-01-11 00:00:00.000,서울강북구,9,6,3,6,66.67
2021-01-11 00:00:00.000,서울관악구봉천1동,3,3,2,1,33.33
2021-01-11 00:00:00.000,기,4,3,2,2,50
2021-01-11 00:00:00.000,강북구,1,1,1,0,0
2021-01-11 00:00:00.000,광진구,1,1,0,1,100
2021-01-11 00:00:00.000,산,2,1,2,0,0
2021-01-11 00:00:00.000,남,1,1,1,0,0
2021-01-11 00:00:00.000,서울시,5,1,1,4,80
2021-01-11 00:00:00.000,북,2,1,1,1,50
2021-01-11 00:00:00.000,대동@,1,1,1,0,0
2021-01-18 00:00:00.000,서울특별시,50107,31289,28033,22074,44.05
2021-01-18 00:00:00.000,경기도,18580,11495,10342,8238,44.34
2021-01-18 00:00:00.000,인천광역시,3198,1841,1781,1417,44.31
2021-01-18 00:00:00.000,서울,2418,1717,1377,1041,43.05
2021-01-18 00:00:00.000,충청남도,2130,1297,1162,968,45.45
2021-01-18 00:00:00.000,경상북도,1886,1085,997,889,47.14
2021-01-18 00:00:00.000,강원도,1895,1080,978,917,48.39
2021-01-18 00:00:00.000,경상남도,1552,887,771,781,50.32
2021-01-18 00:00:00.000,충청북도,1398,809,756,642,45.92
2021-01-18 00:00:00.000,,1010,774,647,363,35.94
2021-01-18 00:00:00.000,전라북도,1307,751,705,602,46.06
2021-01-18 00:00:00.000,전라남도,1313,721,650,663,50.5
2021-01-18 00:00:00.000,부산광역시,1368,695,675,693,50.66
2021-01-18 00:00:00.000,대전광역시,1139,635,590,549,48.2
2021-01-18 00:00:00.000,경기,758,533,462,296,39.05
2021-01-18 00:00:00.000,대구광역시,891,479,447,444,49.83
2021-01-18 00:00:00.000,광주광역시,857,469,452,405,47.26
2021-01-18 00:00:00.000,제주특별자치도,677,344,345,332,49.04
2021-01-18 00:00:00.000,울산광역시,484,252,250,234,48.35
2021-01-18 00:00:00.000,세종특별자치시,350,214,202,148,42.29
2021-01-18 00:00:00.000,인천광역,146,104,84,62,42.47
2021-01-18 00:00:00.000,인천,88,67,56,32,36.36
2021-01-18 00:00:00.000,충남,82,58,48,34,41.46
2021-01-18 00:00:00.000,경북,69,43,27,42,60.87
2021-01-18 00:00:00.000,충북,54,40,29,25,46.3
2021-01-18 00:00:00.000,경남,63,39,27,36,57.14
2021-01-18 00:00:00.000,강원,48,34,21,27,56.25
2021-01-18 00:00:00.000,전북,39,28,17,22,56.41
2021-01-18 00:00:00.000,대전광역,35,27,20,15,42.86
2021-01-18 00:00:00.000,전남,36,26,22,14,38.89
2021-01-18 00:00:00.000,부산광역,37,25,17,20,54.05
2021-01-18 00:00:00.000,광주,39,24,23,16,41.03
2021-01-18 00:00:00.000,광주광역,35,20,19,16,45.71
2021-01-18 00:00:00.000,대전,25,20,16,9,36
2021-01-18 00:00:00.000,부산,27,15,15,12,44.44
2021-01-18 00:00:00.000,대구광역,18,13,7,11,61.11
2021-01-18 00:00:00.000,울산,20,11,5,15,75
2021-01-18 00:00:00.000,서울강북구,14,10,8,6,42.86
2021-01-18 00:00:00.000,★★★★★★★★,15,10,4,11,73.33
2021-01-18 00:00:00.000,제주도,15,9,4,11,73.33
2021-01-18 00:00:00.000,대구,12,8,7,5,41.67
2021-01-18 00:00:00.000,제주,11,8,6,5,45.45
2021-01-18 00:00:00.000,울산광역,9,7,7,2,22.22
2021-01-18 00:00:00.000,울,5,5,4,1,20
2021-01-18 00:00:00.000,기,6,3,0,6,100
2021-01-18 00:00:00.000,남,4,3,3,1,25
2021-01-18 00:00:00.000,강북구,1,1,0,1,100
2021-01-18 00:00:00.000,북,2,1,1,1,50
2021-01-18 00:00:00.000,경기도화성시송산동,1,1,1,0,0
2021-01-18 00:00:00.000,천,6,1,1,5,83.33
2021-01-18 00:00:00.000,서울시,2,1,1,1,50
2021-01-18 00:00:00.000,산,3,1,2,1,33.33
2021-01-18 00:00:00.000,서울관악구봉천1동,1,1,1,0,0
2021-01-25 00:00:00.000,서울특별시,48421,30335,27125,21296,43.98
2021-01-25 00:00:00.000,경기도,17982,11109,9998,7984,44.4
2021-01-25 00:00:00.000,인천광역시,3161,1853,1716,1445,45.71
2021-01-25 00:00:00.000,서울,2292,1639,1300,992,43.28
2021-01-25 00:00:00.000,충청남도,2171,1288,1176,995,45.83
2021-01-25 00:00:00.000,강원도,1792,1079,1002,790,44.08
2021-01-25 00:00:00.000,경상북도,1900,1046,974,926,48.74
2021-01-25 00:00:00.000,충청북도,1473,863,798,675,45.82
2021-01-25 00:00:00.000,경상남도,1611,849,770,841,52.2
2021-01-25 00:00:00.000,,945,723,627,318,33.65
2021-01-25 00:00:00.000,전라북도,1312,721,654,658,50.15
2021-01-25 00:00:00.000,전라남도,1288,720,659,629,48.84
2021-01-25 00:00:00.000,부산광역시,1225,667,633,592,48.33
2021-01-25 00:00:00.000,대전광역시,1129,655,566,563,49.87
2021-01-25 00:00:00.000,대구광역시,880,517,469,411,46.7
2021-01-25 00:00:00.000,경기,722,499,375,347,48.06
2021-01-25 00:00:00.000,광주광역시,840,449,434,406,48.33
2021-01-25 00:00:00.000,제주특별자치도,705,330,345,360,51.06
2021-01-25 00:00:00.000,울산광역시,501,271,249,252,50.3
2021-01-25 00:00:00.000,세종특별자치시,337,199,185,152,45.1
2021-01-25 00:00:00.000,인천광역,142,102,87,55,38.73
2021-01-25 00:00:00.000,인천,84,59,51,33,39.29
2021-01-25 00:00:00.000,충남,89,55,46,43,48.31
2021-01-25 00:00:00.000,경남,75,44,28,47,62.67
2021-01-25 00:00:00.000,충북,49,34,33,16,32.65
2021-01-25 00:00:00.000,경북,56,34,28,28,50
2021-01-25 00:00:00.000,강원,38,29,23,15,39.47
2021-01-25 00:00:00.000,부산광역,35,26,14,21,60
2021-01-25 00:00:00.000,전북,39,25,22,17,43.59
2021-01-25 00:00:00.000,광주광역,31,23,13,18,58.06
2021-01-25 00:00:00.000,대전광역,28,19,10,18,64.29
2021-01-25 00:00:00.000,대전,26,16,13,13,50
2021-01-25 00:00:00.000,전남,22,16,12,10,45.45
2021-01-25 00:00:00.000,광주,21,15,12,9,42.86
2021-01-25 00:00:00.000,부산,18,14,12,6,33.33
2021-01-25 00:00:00.000,대구광역,21,12,10,11,52.38
2021-01-25 00:00:00.000,★★★★★★★★,14,12,8,6,42.86
2021-01-25 00:00:00.000,울산,15,10,5,10,66.67
2021-01-25 00:00:00.000,대구,12,9,7,5,41.67
2021-01-25 00:00:00.000,제주도,11,7,5,6,54.55
2021-01-25 00:00:00.000,기,9,7,4,5,55.56
2021-01-25 00:00:00.000,서울강북구,8,7,6,2,25
2021-01-25 00:00:00.000,울산광역,8,6,5,3,37.5
2021-01-25 00:00:00.000,울,9,5,7,2,22.22
2021-01-25 00:00:00.000,서울시,3,3,2,1,33.33
2021-01-25 00:00:00.000,제주,3,2,0,3,100
2021-01-25 00:00:00.000,주,2,1,0,2,100
2021-01-25 00:00:00.000,북,1,1,1,0,0
2021-01-25 00:00:00.000,인천시,1,1,0,1,100
2021-01-25 00:00:00.000,강북구,1,1,0,1,100
2021-02-01 00:00:00.000,서울특별시,49444,31120,27790,21654,43.8
2021-02-01 00:00:00.000,경기도,18583,11547,10493,8090,43.53
2021-02-01 00:00:00.000,인천광역시,3100,1849,1750,1350,43.55
2021-02-01 00:00:00.000,서울,2305,1614,1354,951,41.26
2021-02-01 00:00:00.000,충청남도,2210,1308,1212,998,45.16
2021-02-01 00:00:00.000,경상북도,1904,1072,980,924,48.53
2021-02-01 00:00:00.000,강원도,1785,1040,960,825,46.22
2021-02-01 00:00:00.000,경상남도,1592,873,795,797,50.06
2021-02-01 00:00:00.000,충청북도,1352,831,750,602,44.53
2021-02-01 00:00:00.000,전라북도,1356,751,702,654,48.23
2021-02-01 00:00:00.000,,945,727,645,300,31.75
2021-02-01 00:00:00.000,전라남도,1372,720,709,663,48.32
2021-02-01 00:00:00.000,부산광역시,1289,664,685,604,46.86
2021-02-01 00:00:00.000,대전광역시,1142,652,621,521,45.62
2021-02-01 00:00:00.000,경기,814,558,460,354,43.49
2021-02-01 00:00:00.000,대구광역시,835,477,471,364,43.59
2021-02-01 00:00:00.000,광주광역시,801,443,445,356,44.44
2021-02-01 00:00:00.000,제주특별자치도,704,383,384,320,45.45
2021-02-01 00:00:00.000,울산광역시,535,274,284,251,46.92
2021-02-01 00:00:00.000,세종특별자치시,325,202,188,137,42.15
2021-02-01 00:00:00.000,인천,137,85,72,65,47.45
2021-02-01 00:00:00.000,인천광역,108,82,69,39,36.11
2021-02-01 00:00:00.000,충남,81,58,49,32,39.51
2021-02-01 00:00:00.000,경북,53,38,32,21,39.62
2021-02-01 00:00:00.000,경남,51,31,29,22,43.14
2021-02-01 00:00:00.000,강원,42,30,24,18,42.86
2021-02-01 00:00:00.000,충북,40,29,22,18,45
2021-02-01 00:00:00.000,대전광역,33,28,22,11,33.33
2021-02-01 00:00:00.000,광주광역,35,25,18,17,48.57
2021-02-01 00:00:00.000,광주,36,22,20,16,44.44
2021-02-01 00:00:00.000,전북,28,21,19,9,32.14
2021-02-01 00:00:00.000,부산광역,23,19,12,11,47.83
2021-02-01 00:00:00.000,전남,31,17,15,16,51.61
2021-02-01 00:00:00.000,부산,22,16,11,11,50
2021-02-01 00:00:00.000,★★★★★★★★,20,15,8,12,60
2021-02-01 00:00:00.000,울산,18,13,12,6,33.33
2021-02-01 00:00:00.000,대전,12,11,9,3,25
2021-02-01 00:00:00.000,서울강북구,12,11,7,5,41.67
2021-02-01 00:00:00.000,울산광역,15,11,8,7,46.67
2021-02-01 00:00:00.000,대구광역,15,10,9,6,40
2021-02-01 00:00:00.000,제주도,16,9,5,11,68.75
2021-02-01 00:00:00.000,울,10,8,6,4,40
2021-02-01 00:00:00.000,대구,7,6,3,4,57.14
2021-02-01 00:00:00.000,제주,10,6,4,6,60
2021-02-01 00:00:00.000,기,7,5,6,1,14.29
2021-02-01 00:00:00.000,경기도화성시송산동,3,2,1,2,66.67
2021-02-01 00:00:00.000,서울시,1,1,0,1,100
2021-02-01 00:00:00.000,경기용인시풍덕천2동,1,1,1,0,0
2021-02-01 00:00:00.000,원,2,1,1,1,50
2021-02-01 00:00:00.000,강북구,1,1,1,0,0
2021-02-01 00:00:00.000,울주군,1,1,1,0,0
2021-02-01 00:00:00.000,남,2,1,0,2,100
2021-02-01 00:00:00.000,광주시,1,1,1,0,0
2021-02-01 00:00:00.000,주,1,1,1,0,0
2021-02-01 00:00:00.000,인천시,1,1,1,0,0
2021-02-08 00:00:00.000,서울특별시,32159,21424,18190,13969,43.44
2021-02-08 00:00:00.000,경기도,11859,7674,6724,5135,43.3
2021-02-08 00:00:00.000,인천광역시,2170,1287,1146,1024,47.19
2021-02-08 00:00:00.000,서울,1333,1018,790,543,40.74
2021-02-08 00:00:00.000,충청남도,1280,811,717,563,43.98
2021-02-08 00:00:00.000,강원도,1032,652,602,430,41.67
2021-02-08 00:00:00.000,경상북도,986,588,495,491,49.8
2021-02-08 00:00:00.000,,690,576,487,203,29.42
2021-02-08 00:00:00.000,충청북도,842,527,476,366,43.47
2021-02-08 00:00:00.000,경상남도,900,504,429,471,52.33
2021-02-08 00:00:00.000,전라북도,754,454,401,353,46.82
2021-02-08 00:00:00.000,전라남도,709,415,346,363,51.2
2021-02-08 00:00:00.000,부산광역시,697,388,367,330,47.35
2021-02-08 00:00:00.000,대전광역시,634,363,318,316,49.84
2021-02-08 00:00:00.000,경기,434,319,246,188,43.32
2021-02-08 00:00:00.000,대구광역시,478,302,228,250,52.3
2021-02-08 00:00:00.000,광주광역시,472,265,222,250,52.97
2021-02-08 00:00:00.000,제주특별자치도,402,231,222,180,44.78
2021-02-08 00:00:00.000,울산광역시,306,176,163,143,46.73
2021-02-08 00:00:00.000,세종특별자치시,193,120,111,82,42.49
2021-02-08 00:00:00.000,인천광역,86,62,51,35,40.7
2021-02-08 00:00:00.000,인천,65,49,39,26,40
2021-02-08 00:00:00.000,강원,35,27,18,17,48.57
2021-02-08 00:00:00.000,경북,37,27,19,18,48.65
2021-02-08 00:00:00.000,충남,29,24,16,13,44.83
2021-02-08 00:00:00.000,전북,25,17,12,13,52
2021-02-08 00:00:00.000,충북,18,16,14,4,22.22
2021-02-08 00:00:00.000,대전광역,23,15,11,12,52.17
2021-02-08 00:00:00.000,경남,24,15,10,14,58.33
2021-02-08 00:00:00.000,부산광역,21,12,8,13,61.9
2021-02-08 00:00:00.000,전남,14,12,11,3,21.43
2021-02-08 00:00:00.000,대구,22,12,7,15,68.18
2021-02-08 00:00:00.000,광주광역,11,9,7,4,36.36
2021-02-08 00:00:00.000,★★★★★★★★,12,9,6,6,50
2021-02-08 00:00:00.000,부산,13,9,7,6,46.15
2021-02-08 00:00:00.000,대전,14,8,4,10,71.43
2021-02-08 00:00:00.000,울,11,8,6,5,45.45
2021-02-08 00:00:00.000,서울강북구,8,7,5,3,37.5
2021-02-08 00:00:00.000,제주도,7,6,4,3,42.86
2021-02-08 00:00:00.000,광주,7,6,3,4,57.14
2021-02-08 00:00:00.000,울산,8,5,4,4,50
2021-02-08 00:00:00.000,대구광역,5,4,1,4,80
2021-02-08 00:00:00.000,울산광역,3,3,1,2,66.67
2021-02-08 00:00:00.000,기,6,2,0,6,100
2021-02-08 00:00:00.000,남,3,2,1,2,66.67
2021-02-08 00:00:00.000,천,4,1,1,3,75
2021-02-08 00:00:00.000,제주,1,1,1,0,0
2021-02-08 00:00:00.000,서울시,3,1,0,3,100
2021-02-08 00:00:00.000,산,2,1,2,0,0
2021-02-15 00:00:00.000,서울특별시,52024,32336,28898,23126,44.45
2021-02-15 00:00:00.000,경기도,19725,12061,10897,8828,44.76
2021-02-15 00:00:00.000,인천광역시,3467,2055,1892,1575,45.43
2021-02-15 00:00:00.000,서울,2330,1658,1318,1012,43.43
2021-02-15 00:00:00.000,충청남도,2355,1456,1326,1029,43.69
2021-02-15 00:00:00.000,경상북도,2166,1214,1172,994,45.89
2021-02-15 00:00:00.000,강원도,1968,1114,1073,895,45.48
2021-02-15 00:00:00.000,경상남도,1909,1031,957,952,49.87
2021-02-15 00:00:00.000,충청북도,1553,897,848,705,45.4
2021-02-15 00:00:00.000,전라남도,1477,844,745,732,49.56
2021-02-15 00:00:00.000,,1038,801,693,345,33.24
2021-02-15 00:00:00.000,전라북도,1455,794,746,709,48.73
2021-02-15 00:00:00.000,부산광역시,1328,717,690,638,48.04
2021-02-15 00:00:00.000,대전광역시,1198,700,679,519,43.32
2021-02-15 00:00:00.000,경기,832,575,447,385,46.27
2021-02-15 00:00:00.000,대구광역시,1020,544,486,534,52.35
2021-02-15 00:00:00.000,광주광역시,904,491,501,403,44.58
2021-02-15 00:00:00.000,제주특별자치도,767,383,396,371,48.37
2021-02-15 00:00:00.000,울산광역시,575,311,329,246,42.78
2021-02-15 00:00:00.000,세종특별자치시,398,239,199,199,50
2021-02-15 00:00:00.000,인천광역,136,99,80,56,41.18
2021-02-15 00:00:00.000,인천,97,71,56,41,42.27
2021-02-15 00:00:00.000,충남,61,47,40,21,34.43
2021-02-15 00:00:00.000,강원,69,43,30,39,56.52
2021-02-15 00:00:00.000,경남,76,43,32,44,57.89
2021-02-15 00:00:00.000,충북,63,41,28,35,55.56
2021-02-15 00:00:00.000,경북,58,38,27,31,53.45
2021-02-15 00:00:00.000,부산,48,31,24,24,50
2021-02-15 00:00:00.000,광주,45,31,20,25,55.56
2021-02-15 00:00:00.000,광주광역,29,26,22,7,24.14
2021-02-15 00:00:00.000,대전광역,35,23,18,17,48.57
2021-02-15 00:00:00.000,부산광역,39,20,21,18,46.15
2021-02-15 00:00:00.000,전북,30,20,19,11,36.67
2021-02-15 00:00:00.000,대전,31,20,11,20,64.52
2021-02-15 00:00:00.000,전남,38,20,16,22,57.89
2021-02-15 00:00:00.000,대구광역,26,16,11,15,57.69
2021-02-15 00:00:00.000,대구,20,16,13,7,35
2021-02-15 00:00:00.000,★★★★★★★★,22,15,9,13,59.09
2021-02-15 00:00:00.000,제주도,25,12,9,16,64
2021-02-15 00:00:00.000,울산광역,13,10,8,5,38.46
2021-02-15 00:00:00.000,서울강북구,14,10,9,5,35.71
2021-02-15 00:00:00.000,제주,17,10,5,12,70.59
2021-02-15 00:00:00.000,울,12,8,4,8,66.67
2021-02-15 00:00:00.000,기,13,8,6,7,53.85
2021-02-15 00:00:00.000,울산,10,7,2,8,80
2021-02-15 00:00:00.000,산,9,3,1,8,88.89
2021-02-15 00:00:00.000,서울시,7,3,2,5,71.43
2021-02-15 00:00:00.000,원주시,2,2,2,0,0
2021-02-15 00:00:00.000,천,1,1,1,0,0
2021-02-15 00:00:00.000,서울관악구봉천1동,1,1,1,0,0
2021-02-15 00:00:00.000,광주시,2,1,1,1,50
2021-02-15 00:00:00.000,남,1,1,1,0,0
2021-02-15 00:00:00.000,기도,1,1,1,0,0
2021-02-15 00:00:00.000,경기도화성시송산동,1,1,1,0,0
2021-02-22 00:00:00.000,서울특별시,50936,31697,28627,22309,43.8
2021-02-22 00:00:00.000,경기도,18992,11732,10738,8254,43.46
2021-02-22 00:00:00.000,인천광역시,3194,1874,1800,1394,43.64
2021-02-22 00:00:00.000,서울,2276,1602,1314,962,42.27
2021-02-22 00:00:00.000,충청남도,2329,1355,1288,1041,44.7
2021-02-22 00:00:00.000,경상북도,2085,1207,1145,940,45.08
2021-02-22 00:00:00.000,강원도,1827,1067,1008,819,44.83
2021-02-22 00:00:00.000,경상남도,1764,976,951,813,46.09
2021-02-22 00:00:00.000,충청북도,1409,817,808,601,42.65
2021-02-22 00:00:00.000,전라남도,1373,765,714,659,48
2021-02-22 00:00:00.000,전라북도,1319,761,710,609,46.17
2021-02-22 00:00:00.000,,953,754,659,294,30.85
2021-02-22 00:00:00.000,부산광역시,1360,714,711,649,47.72
2021-02-22 00:00:00.000,대전광역시,1102,619,618,484,43.92
2021-02-22 00:00:00.000,경기,803,552,447,356,44.33
2021-02-22 00:00:00.000,대구광역시,951,544,490,461,48.48
2021-02-22 00:00:00.000,광주광역시,921,486,483,438,47.56
2021-02-22 00:00:00.000,제주특별자치도,696,353,367,329,47.27
2021-02-22 00:00:00.000,울산광역시,529,287,288,241,45.56
2021-02-22 00:00:00.000,세종특별자치시,388,226,213,175,45.1
2021-02-22 00:00:00.000,인천광역,115,81,63,52,45.22
2021-02-22 00:00:00.000,충남,88,62,52,36,40.91
2021-02-22 00:00:00.000,인천,87,56,49,38,43.68
2021-02-22 00:00:00.000,경남,73,55,37,36,49.32
2021-02-22 00:00:00.000,강원,73,49,35,38,52.05
2021-02-22 00:00:00.000,경북,59,41,33,26,44.07
2021-02-22 00:00:00.000,충북,58,37,23,35,60.34
2021-02-22 00:00:00.000,전남,39,27,23,16,41.03
2021-02-22 00:00:00.000,부산광역,43,25,21,22,51.16
2021-02-22 00:00:00.000,광주,43,24,15,28,65.12
2021-02-22 00:00:00.000,대전,37,23,22,15,40.54
2021-02-22 00:00:00.000,대전광역,30,22,22,8,26.67
2021-02-22 00:00:00.000,★★★★★★★★,30,22,10,20,66.67
2021-02-22 00:00:00.000,전북,33,21,19,14,42.42
2021-02-22 00:00:00.000,부산,31,17,12,19,61.29
2021-02-22 00:00:00.000,대구광역,25,16,12,13,52
2021-02-22 00:00:00.000,광주광역,23,15,13,10,43.48
2021-02-22 00:00:00.000,대구,19,14,13,6,31.58
2021-02-22 00:00:00.000,제주도,17,11,3,14,82.35
2021-02-22 00:00:00.000,울산,15,10,8,7,46.67
2021-02-22 00:00:00.000,제주,8,7,6,2,25
2021-02-22 00:00:00.000,울,8,6,5,3,37.5
2021-02-22 00:00:00.000,서울강북구,6,5,4,2,33.33
2021-02-22 00:00:00.000,울산광역,4,4,3,1,25
2021-02-22 00:00:00.000,기,5,4,2,3,60
2021-02-22 00:00:00.000,산,5,3,3,2,40
2021-02-22 00:00:00.000,서울시,5,3,3,2,40
2021-02-22 00:00:00.000,주,1,1,1,0,0
2021-02-22 00:00:00.000,광주시,1,1,1,0,0
2021-02-22 00:00:00.000,원주시,4,1,0,4,100
2021-02-22 00:00:00.000,경기양평군양서면,1,1,1,0,0
2021-02-22 00:00:00.000,천,3,1,0,3,100
2021-02-22 00:00:00.000,인헌12다길,5,1,1,4,80
2021-02-22 00:00:00.000,남,1,1,1,0,0
2021-02-22 00:00:00.000,서초구,2,1,1,1,50
2021-03-01 00:00:00.000,서울특별시,41406,26621,22766,18640,45.02
2021-03-01 00:00:00.000,경기도,15106,9527,8327,6779,44.88
2021-03-01 00:00:00.000,인천광역시,2569,1553,1382,1187,46.2
2021-03-01 00:00:00.000,서울,1850,1336,1057,793,42.86
2021-03-01 00:00:00.000,충청남도,1871,1117,982,889,47.51
2021-03-01 00:00:00.000,경상북도,1704,978,890,814,47.77
2021-03-01 00:00:00.000,강원도,1501,906,822,679,45.24
2021-03-01 00:00:00.000,경상남도,1210,719,639,571,47.19
2021-03-01 00:00:00.000,충청북도,1075,644,582,493,45.86
2021-03-01 00:00:00.000,,787,641,552,235,29.86
2021-03-01 00:00:00.000,전라북도,1102,618,552,550,49.91
2021-03-01 00:00:00.000,전라남도,1050,617,572,478,45.52
2021-03-01 00:00:00.000,부산광역시,1010,568,522,488,48.32
2021-03-01 00:00:00.000,대전광역시,877,534,475,402,45.84
2021-03-01 00:00:00.000,경기,600,436,342,258,43
2021-03-01 00:00:00.000,대구광역시,698,401,379,319,45.7
2021-03-01 00:00:00.000,광주광역시,696,384,399,297,42.67
2021-03-01 00:00:00.000,제주특별자치도,561,312,277,284,50.62
2021-03-01 00:00:00.000,울산광역시,443,256,243,200,45.15
2021-03-01 00:00:00.000,세종특별자치시,334,192,181,153,45.81
2021-03-01 00:00:00.000,인천,96,62,47,49,51.04
2021-03-01 00:00:00.000,인천광역,71,57,44,27,38.03
2021-03-01 00:00:00.000,경북,60,37,33,27,45
2021-03-01 00:00:00.000,충남,54,34,27,27,50
2021-03-01 00:00:00.000,경남,63,33,25,38,60.32
2021-03-01 00:00:00.000,강원,46,33,23,23,50
2021-03-01 00:00:00.000,부산,39,25,28,11,28.21
2021-03-01 00:00:00.000,부산광역,34,23,21,13,38.24
2021-03-01 00:00:00.000,광주,32,20,17,15,46.88
2021-03-01 00:00:00.000,충북,27,18,16,11,40.74
2021-03-01 00:00:00.000,★★★★★★★★,22,17,10,12,54.55
2021-03-01 00:00:00.000,전북,22,15,13,9,40.91
2021-03-01 00:00:00.000,광주광역,22,14,14,8,36.36
2021-03-01 00:00:00.000,제주,28,14,18,10,35.71
2021-03-01 00:00:00.000,대전,22,12,11,11,50
2021-03-01 00:00:00.000,대전광역,12,11,10,2,16.67
2021-03-01 00:00:00.000,전남,16,11,8,8,50
2021-03-01 00:00:00.000,서울강북구,15,9,4,11,73.33
2021-03-01 00:00:00.000,제주도,13,9,6,7,53.85
2021-03-01 00:00:00.000,대구,8,8,6,2,25
2021-03-01 00:00:00.000,대구광역,10,8,9,1,10
2021-03-01 00:00:00.000,울,12,7,8,4,33.33
2021-03-01 00:00:00.000,울산,6,5,4,2,33.33
2021-03-01 00:00:00.000,기,4,4,3,1,25
2021-03-01 00:00:00.000,울산광역,5,4,3,2,40
2021-03-01 00:00:00.000,광주시,2,1,1,1,50
2021-03-01 00:00:00.000,남,2,1,0,2,100
2021-03-01 00:00:00.000,서울시,1,1,0,1,100
2021-03-01 00:00:00.000,산,1,1,0,1,100
2021-03-01 00:00:00.000,원주시,1,1,1,0,0
2021-03-01 00:00:00.000,인헌12다길,1,1,1,0,0
2021-03-01 00:00:00.000,인천직할시,1,1,1,0,0
2021-03-08 00:00:00.000,서울특별시,50157,31441,28096,22061,43.98
2021-03-08 00:00:00.000,경기도,18655,11370,10305,8350,44.76
2021-03-08 00:00:00.000,인천광역시,3076,1826,1709,1367,44.44
2021-03-08 00:00:00.000,서울,2255,1606,1329,926,41.06
2021-03-08 00:00:00.000,충청남도,2222,1339,1248,974,43.83
2021-03-08 00:00:00.000,경상북도,1948,1111,1044,904,46.41
2021-03-08 00:00:00.000,강원도,1679,1038,936,743,44.25
2021-03-08 00:00:00.000,경상남도,1727,917,858,869,50.32
2021-03-08 00:00:00.000,충청북도,1389,844,801,588,42.33
2021-03-08 00:00:00.000,,980,759,673,307,31.33
2021-03-08 00:00:00.000,전라북도,1331,743,686,645,48.46
2021-03-08 00:00:00.000,전라남도,1255,705,688,567,45.18
2021-03-08 00:00:00.000,부산광역시,1275,677,651,624,48.94
2021-03-08 00:00:00.000,대전광역시,1097,625,595,502,45.76
2021-03-08 00:00:00.000,대구광역시,905,539,508,397,43.87
2021-03-08 00:00:00.000,광주광역시,945,491,474,471,49.84
2021-03-08 00:00:00.000,경기,721,489,412,309,42.86
2021-03-08 00:00:00.000,제주특별자치도,722,377,376,346,47.92
2021-03-08 00:00:00.000,울산광역시,472,277,251,221,46.82
2021-03-08 00:00:00.000,세종특별자치시,381,213,214,167,43.83
2021-03-08 00:00:00.000,인천광역,124,93,72,52,41.94
2021-03-08 00:00:00.000,인천,91,70,61,30,32.97
2021-03-08 00:00:00.000,충남,89,62,50,39,43.82
2021-03-08 00:00:00.000,강원,71,44,32,39,54.93
2021-03-08 00:00:00.000,경남,75,41,44,31,41.33
2021-03-08 00:00:00.000,경북,53,36,32,21,39.62
2021-03-08 00:00:00.000,부산광역,46,32,30,16,34.78
2021-03-08 00:00:00.000,광주광역,46,31,22,24,52.17
2021-03-08 00:00:00.000,대전,35,26,20,15,42.86
2021-03-08 00:00:00.000,전북,33,23,26,7,21.21
2021-03-08 00:00:00.000,충북,32,23,22,10,31.25
2021-03-08 00:00:00.000,부산,33,22,18,15,45.45
2021-03-08 00:00:00.000,전남,30,22,18,12,40
2021-03-08 00:00:00.000,제주,22,17,12,10,45.45
2021-03-08 00:00:00.000,대전광역,26,16,10,16,61.54
2021-03-08 00:00:00.000,★★★★★★★★,18,14,13,5,27.78
2021-03-08 00:00:00.000,대구광역,24,12,11,13,54.17
2021-03-08 00:00:00.000,대구,23,12,11,12,52.17
2021-03-08 00:00:00.000,서울강북구,17,11,10,7,41.18
2021-03-08 00:00:00.000,광주,16,11,10,6,37.5
2021-03-08 00:00:00.000,제주도,12,10,10,2,16.67
2021-03-08 00:00:00.000,울산,15,8,9,6,40
2021-03-08 00:00:00.000,울산광역,11,8,6,5,45.45
2021-03-08 00:00:00.000,울,9,7,5,4,44.44
2021-03-08 00:00:00.000,천,7,5,6,1,14.29
2021-03-08 00:00:00.000,남,6,4,2,4,66.67
2021-03-08 00:00:00.000,산,4,2,2,2,50
2021-03-08 00:00:00.000,기,3,2,0,3,100
2021-03-08 00:00:00.000,서울시,4,2,0,4,100
2021-03-08 00:00:00.000,인헌12다길,1,1,1,0,0
2021-03-08 00:00:00.000,경기도화성시송산동,1,1,1,0,0
2021-03-08 00:00:00.000,서울강북구번3동,1,1,1,0,0
2021-03-08 00:00:00.000,서대문구,1,1,1,0,0
2021-03-08 00:00:00.000,주,1,1,0,1,100
2021-03-15 00:00:00.000,서울특별시,49185,30745,27552,21633,43.98
2021-03-15 00:00:00.000,경기도,18401,11266,10341,8060,43.8
2021-03-15 00:00:00.000,인천광역시,3198,1857,1750,1448,45.28
2021-03-15 00:00:00.000,서울,2252,1585,1298,954,42.36
2021-03-15 00:00:00.000,충청남도,2152,1262,1172,980,45.54
2021-03-15 00:00:00.000,경상북도,1954,1128,1040,914,46.78
2021-03-15 00:00:00.000,강원도,1731,1011,974,757,43.73
2021-03-15 00:00:00.000,경상남도,1610,861,812,798,49.57
2021-03-15 00:00:00.000,충청북도,1385,816,738,647,46.71
2021-03-15 00:00:00.000,,997,786,656,341,34.2
2021-03-15 00:00:00.000,전라남도,1370,741,700,670,48.91
2021-03-15 00:00:00.000,전라북도,1289,735,694,595,46.16
2021-03-15 00:00:00.000,부산광역시,1283,672,637,646,50.35
2021-03-15 00:00:00.000,대전광역시,1056,618,581,475,44.98
2021-03-15 00:00:00.000,경기,753,522,420,333,44.22
2021-03-15 00:00:00.000,광주광역시,856,468,471,385,44.98
2021-03-15 00:00:00.000,대구광역시,800,451,401,399,49.88
2021-03-15 00:00:00.000,제주특별자치도,737,392,371,366,49.66
2021-03-15 00:00:00.000,울산광역시,473,268,267,206,43.55
2021-03-15 00:00:00.000,세종특별자치시,354,213,202,152,42.94
2021-03-15 00:00:00.000,인천광역,132,102,83,49,37.12
2021-03-15 00:00:00.000,충남,85,59,49,36,42.35
2021-03-15 00:00:00.000,강원,59,47,34,25,42.37
2021-03-15 00:00:00.000,인천,60,43,37,23,38.33
2021-03-15 00:00:00.000,경남,63,41,32,31,49.21
2021-03-15 00:00:00.000,경북,63,39,37,26,41.27
2021-03-15 00:00:00.000,충북,48,31,24,24,50
2021-03-15 00:00:00.000,전남,49,27,22,27,55.1
2021-03-15 00:00:00.000,광주광역,30,23,15,15,50
2021-03-15 00:00:00.000,부산광역,33,21,11,22,66.67
2021-03-15 00:00:00.000,부산,29,20,12,17,58.62
2021-03-15 00:00:00.000,★★★★★★★★,27,20,11,16,59.26
2021-03-15 00:00:00.000,제주,24,17,12,12,50
2021-03-15 00:00:00.000,대전광역,27,16,16,11,40.74
2021-03-15 00:00:00.000,전북,20,16,16,4,20
2021-03-15 00:00:00.000,대구,24,16,14,10,41.67
2021-03-15 00:00:00.000,대전,25,15,14,11,44
2021-03-15 00:00:00.000,광주,22,15,13,9,40.91
2021-03-15 00:00:00.000,대구광역,22,14,12,10,45.45
2021-03-15 00:00:00.000,울산광역,21,12,9,12,57.14
2021-03-15 00:00:00.000,울산,11,9,5,6,54.55
2021-03-15 00:00:00.000,서울강북구,10,9,7,3,30
2021-03-15 00:00:00.000,제주도,10,8,6,4,40
2021-03-15 00:00:00.000,울,10,7,6,4,40
2021-03-15 00:00:00.000,기,6,5,3,3,50
2021-03-15 00:00:00.000,서울시,3,3,2,1,33.33
2021-03-15 00:00:00.000,남,3,2,2,1,33.33
2021-03-15 00:00:00.000,주,2,2,2,0,0
2021-03-22 00:00:00.000,서울특별시,49268,31104,27747,21521,43.68
2021-03-22 00:00:00.000,경기도,18499,11294,10367,8132,43.96
2021-03-22 00:00:00.000,인천광역시,3143,1835,1696,1447,46.04
2021-03-22 00:00:00.000,서울,2141,1526,1207,934,43.62
2021-03-22 00:00:00.000,충청남도,2167,1292,1207,960,44.3
2021-03-22 00:00:00.000,경상북도,2166,1185,1115,1051,48.52
2021-03-22 00:00:00.000,강원도,1761,1047,975,786,44.63
2021-03-22 00:00:00.000,경상남도,1673,927,840,833,49.79
2021-03-22 00:00:00.000,,1030,815,699,331,32.14
2021-03-22 00:00:00.000,충청북도,1316,777,733,583,44.3
2021-03-22 00:00:00.000,전라북도,1252,702,650,602,48.08
2021-03-22 00:00:00.000,전라남도,1233,695,644,589,47.77
2021-03-22 00:00:00.000,부산광역시,1248,682,638,610,48.88
2021-03-22 00:00:00.000,대전광역시,1042,592,569,473,45.39
2021-03-22 00:00:00.000,경기,787,568,427,360,45.74
2021-03-22 00:00:00.000,대구광역시,864,507,465,399,46.18
2021-03-22 00:00:00.000,광주광역시,816,444,411,405,49.63
2021-03-22 00:00:00.000,제주특별자치도,723,375,393,330,45.64
2021-03-22 00:00:00.000,울산광역시,508,270,264,244,48.03
2021-03-22 00:00:00.000,세종특별자치시,368,213,203,165,44.84
2021-03-22 00:00:00.000,인천광역,124,93,75,49,39.52
2021-03-22 00:00:00.000,충남,73,53,47,26,35.62
2021-03-22 00:00:00.000,인천,66,50,39,27,40.91
2021-03-22 00:00:00.000,경북,60,41,33,27,45
2021-03-22 00:00:00.000,강원,54,38,31,23,42.59
2021-03-22 00:00:00.000,경남,54,37,33,21,38.89
2021-03-22 00:00:00.000,충북,49,34,21,28,57.14
2021-03-22 00:00:00.000,★★★★★★★★,29,26,19,10,34.48
2021-03-22 00:00:00.000,전남,38,23,16,22,57.89
2021-03-22 00:00:00.000,부산,37,22,10,27,72.97
2021-03-22 00:00:00.000,광주광역,33,19,16,17,51.52
2021-03-22 00:00:00.000,대구광역,25,18,8,17,68
2021-03-22 00:00:00.000,부산광역,22,18,14,8,36.36
2021-03-22 00:00:00.000,전북,20,17,12,8,40
2021-03-22 00:00:00.000,광주,21,16,17,4,19.05
2021-03-22 00:00:00.000,대전광역,23,16,11,12,52.17
2021-03-22 00:00:00.000,대전,20,15,10,10,50
2021-03-22 00:00:00.000,대구,15,13,9,6,40
2021-03-22 00:00:00.000,제주도,16,10,6,10,62.5
2021-03-22 00:00:00.000,제주,14,9,7,7,50
2021-03-22 00:00:00.000,서울강북구,9,7,6,3,33.33
2021-03-22 00:00:00.000,울,8,7,7,1,12.5
2021-03-22 00:00:00.000,울산광역,10,7,9,1,10
2021-03-22 00:00:00.000,울산,9,7,8,1,11.11
2021-03-22 00:00:00.000,서울시,4,3,1,3,75
2021-03-22 00:00:00.000,기,3,3,3,0,0
2021-03-22 00:00:00.000,남,2,2,2,0,0
2021-03-22 00:00:00.000,경기의왕시포일동,3,2,2,1,33.33
2021-03-22 00:00:00.000,강북구,1,1,1,0,0
2021-03-22 00:00:00.000,서울관악구봉천1동,1,1,1,0,0
2021-03-22 00:00:00.000,산,1,1,1,0,0
2021-03-22 00:00:00.000,북,2,1,0,2,100
2021-03-29 00:00:00.000,서울특별시,47446,29853,26704,20742,43.72
2021-03-29 00:00:00.000,경기도,17594,10813,9851,7743,44.01
2021-03-29 00:00:00.000,인천광역시,2921,1738,1609,1312,44.92
2021-03-29 00:00:00.000,서울,2263,1561,1315,948,41.89
2021-03-29 00:00:00.000,충청남도,2175,1308,1213,962,44.23
2021-03-29 00:00:00.000,경상북도,1972,1077,1064,908,46.04
2021-03-29 00:00:00.000,강원도,1647,972,891,756,45.9
2021-03-29 00:00:00.000,경상남도,1534,873,812,722,47.07
2021-03-29 00:00:00.000,,1092,833,696,396,36.26
2021-03-29 00:00:00.000,충청북도,1293,772,731,562,43.46
2021-03-29 00:00:00.000,전라북도,1297,736,708,589,45.41
2021-03-29 00:00:00.000,전라남도,1282,693,647,635,49.53
2021-03-29 00:00:00.000,부산광역시,1191,669,644,547,45.93
2021-03-29 00:00:00.000,대전광역시,1072,601,548,524,48.88
2021-03-29 00:00:00.000,경기,743,523,421,322,43.34
2021-03-29 00:00:00.000,대구광역시,868,492,465,403,46.43
2021-03-29 00:00:00.000,광주광역시,764,413,412,352,46.07
2021-03-29 00:00:00.000,제주특별자치도,669,359,346,323,48.28
2021-03-29 00:00:00.000,울산광역시,520,292,282,238,45.77
2021-03-29 00:00:00.000,세종특별자치시,350,214,200,150,42.86
2021-03-29 00:00:00.000,인천광역,94,66,55,39,41.49
2021-03-29 00:00:00.000,충남,92,59,51,41,44.57
2021-03-29 00:00:00.000,강원,57,45,33,24,42.11
2021-03-29 00:00:00.000,경남,67,45,28,39,58.21
2021-03-29 00:00:00.000,경북,57,41,31,26,45.61
2021-03-29 00:00:00.000,인천,61,41,30,31,50.82
2021-03-29 00:00:00.000,충북,53,35,37,16,30.19
2021-03-29 00:00:00.000,부산광역,48,30,23,25,52.08
2021-03-29 00:00:00.000,전북,42,29,22,20,47.62
2021-03-29 00:00:00.000,부산,38,27,17,21,55.26
2021-03-29 00:00:00.000,전남,42,25,24,18,42.86
2021-03-29 00:00:00.000,광주광역,40,25,17,23,57.5
2021-03-29 00:00:00.000,광주,35,19,14,21,60
2021-03-29 00:00:00.000,대전,26,19,18,8,30.77
2021-03-29 00:00:00.000,대구광역,22,17,12,10,45.45
2021-03-29 00:00:00.000,대전광역,22,17,13,9,40.91
2021-03-29 00:00:00.000,★★★★★★★★,18,16,7,11,61.11
2021-03-29 00:00:00.000,제주,24,12,14,10,41.67
2021-03-29 00:00:00.000,대구,19,11,8,11,57.89
2021-03-29 00:00:00.000,울산광역,18,9,6,12,66.67
2021-03-29 00:00:00.000,서울강북구,9,8,7,2,22.22
2021-03-29 00:00:00.000,기,8,7,3,5,62.5
2021-03-29 00:00:00.000,울,9,6,5,4,44.44
2021-03-29 00:00:00.000,제주도,7,6,6,1,14.29
2021-03-29 00:00:00.000,울산,5,4,3,2,40
2021-03-29 00:00:00.000,서울시,6,3,1,5,83.33
2021-03-29 00:00:00.000,남,3,3,3,0,0
2021-03-29 00:00:00.000,서대문구,1,1,1,0,0
2021-03-29 00:00:00.000,산,6,1,6,0,0
2021-03-29 00:00:00.000,서구,3,1,0,3,100
2021-03-29 00:00:00.000,강북구,1,1,0,1,100
2021-04-05 00:00:00.000,서울특별시,48115,30157,26771,21344,44.36
2021-04-05 00:00:00.000,경기도,18425,11159,10236,8189,44.45
2021-04-05 00:00:00.000,인천광역시,3071,1795,1697,1374,44.74
2021-04-05 00:00:00.000,서울,2359,1675,1360,999,42.35
2021-04-05 00:00:00.000,,1866,1588,723,1143,61.25
2021-04-05 00:00:00.000,충청남도,2218,1318,1246,972,43.82
2021-04-05 00:00:00.000,경상북도,1952,1100,1090,862,44.16
2021-04-05 00:00:00.000,강원도,1663,991,941,722,43.42
2021-04-05 00:00:00.000,경상남도,1634,931,876,758,46.39
2021-04-05 00:00:00.000,충청북도,1308,775,723,585,44.72
2021-04-05 00:00:00.000,전라남도,1335,723,702,633,47.42
2021-04-05 00:00:00.000,전라북도,1274,714,685,589,46.23
2021-04-05 00:00:00.000,부산광역시,1228,668,636,592,48.21
2021-04-05 00:00:00.000,대전광역시,1073,587,551,522,48.65
2021-04-05 00:00:00.000,경기,717,504,392,325,45.33
2021-04-05 00:00:00.000,대구광역시,899,499,460,439,48.83
2021-04-05 00:00:00.000,광주광역시,806,435,420,386,47.89
2021-04-05 00:00:00.000,제주특별자치도,637,336,339,298,46.78
2021-04-05 00:00:00.000,울산광역시,528,286,282,246,46.59
2021-04-05 00:00:00.000,세종특별자치시,330,185,177,153,46.36
2021-04-05 00:00:00.000,인천광역,117,87,70,47,40.17
2021-04-05 00:00:00.000,인천,69,50,36,33,47.83
2021-04-05 00:00:00.000,경남,70,47,36,34,48.57
2021-04-05 00:00:00.000,경북,71,47,46,25,35.21
2021-04-05 00:00:00.000,충남,67,46,42,25,37.31
2021-04-05 00:00:00.000,강원,57,36,36,21,36.84
2021-04-05 00:00:00.000,충북,49,34,25,24,48.98
2021-04-05 00:00:00.000,대전광역,38,26,18,20,52.63
2021-04-05 00:00:00.000,부산광역,28,23,18,10,35.71
2021-04-05 00:00:00.000,전남,38,22,15,23,60.53
2021-04-05 00:00:00.000,광주광역,35,21,18,17,48.57
2021-04-05 00:00:00.000,부산,30,20,16,14,46.67
2021-04-05 00:00:00.000,전북,42,20,23,19,45.24
2021-04-05 00:00:00.000,광주,21,14,10,11,52.38
2021-04-05 00:00:00.000,대구광역,21,14,13,8,38.1
2021-04-05 00:00:00.000,대전,19,13,8,11,57.89
2021-04-05 00:00:00.000,대구,21,13,13,8,38.1
2021-04-05 00:00:00.000,★★★★★★★★,19,13,10,9,47.37
2021-04-05 00:00:00.000,제주,20,10,10,10,50
2021-04-05 00:00:00.000,울산광역,14,9,6,8,57.14
2021-04-05 00:00:00.000,제주도,7,7,5,2,28.57
2021-04-05 00:00:00.000,울산,11,6,4,7,63.64
2021-04-05 00:00:00.000,기,10,6,5,5,50
2021-04-05 00:00:00.000,서울시,8,3,4,4,50
2021-04-05 00:00:00.000,울,3,3,3,0,0
2021-04-05 00:00:00.000,서울강북구,7,3,3,4,57.14
2021-04-05 00:00:00.000,광진구,1,1,0,1,100
2021-04-05 00:00:00.000,천,2,1,1,1,50
2021-04-05 00:00:00.000,산,3,1,2,1,33.33
2021-04-05 00:00:00.000,서구,4,1,1,3,75
2021-04-05 00:00:00.000,북,2,1,1,1,50
2021-04-05 00:00:00.000,광주시,2,1,1,1,50
2021-04-05 00:00:00.000,남,1,1,1,0,0
2021-04-12 00:00:00.000,서울특별시,48785,30686,27266,21519,44.11
2021-04-12 00:00:00.000,경기도,18513,11353,10163,8350,45.1
2021-04-12 00:00:00.000,인천광역시,3172,1843,1732,1440,45.4
2021-04-12 00:00:00.000,서울,2337,1645,1322,1015,43.43
2021-04-12 00:00:00.000,충청남도,2210,1326,1215,995,45.02
2021-04-12 00:00:00.000,경상북도,2036,1132,1101,935,45.92
2021-04-12 00:00:00.000,강원도,1798,1048,943,855,47.55
2021-04-12 00:00:00.000,경상남도,1577,880,795,782,49.59
2021-04-12 00:00:00.000,,1120,873,768,352,31.43
2021-04-12 00:00:00.000,충청북도,1344,800,717,627,46.65
2021-04-12 00:00:00.000,전라남도,1314,718,631,683,51.98
2021-04-12 00:00:00.000,부산광역시,1277,705,672,605,47.38
2021-04-12 00:00:00.000,전라북도,1241,687,661,580,46.74
2021-04-12 00:00:00.000,대전광역시,1119,633,567,552,49.33
2021-04-12 00:00:00.000,경기,730,528,427,303,41.51
2021-04-12 00:00:00.000,대구광역시,916,503,468,448,48.91
2021-04-12 00:00:00.000,광주광역시,819,447,416,403,49.21
2021-04-12 00:00:00.000,제주특별자치도,678,378,363,315,46.46
2021-04-12 00:00:00.000,울산광역시,559,296,299,260,46.51
2021-04-12 00:00:00.000,세종특별자치시,321,188,181,140,43.61
2021-04-12 00:00:00.000,인천광역,101,77,60,41,40.59
2021-04-12 00:00:00.000,인천,76,60,50,26,34.21
2021-04-12 00:00:00.000,충남,88,55,40,48,54.55
2021-04-12 00:00:00.000,경북,62,43,32,30,48.39
2021-04-12 00:00:00.000,강원,59,42,38,21,35.59
2021-04-12 00:00:00.000,충북,60,40,24,36,60
2021-04-12 00:00:00.000,경남,55,38,31,24,43.64
2021-04-12 00:00:00.000,전북,41,27,18,23,56.1
2021-04-12 00:00:00.000,★★★★★★★★,39,26,20,19,48.72
2021-04-12 00:00:00.000,전남,38,23,24,14,36.84
2021-04-12 00:00:00.000,광주광역,32,22,21,11,34.38
2021-04-12 00:00:00.000,부산,30,21,18,12,40
2021-04-12 00:00:00.000,부산광역,32,20,13,19,59.38
2021-04-12 00:00:00.000,대구광역,27,19,15,12,44.44
2021-04-12 00:00:00.000,대구,27,17,15,12,44.44
2021-04-12 00:00:00.000,광주,28,16,13,15,53.57
2021-04-12 00:00:00.000,울산,24,15,13,11,45.83
2021-04-12 00:00:00.000,대전광역,17,13,12,5,29.41
2021-04-12 00:00:00.000,대전,22,13,8,14,63.64
2021-04-12 00:00:00.000,제주,15,11,9,6,40
2021-04-12 00:00:00.000,서울강북구,13,10,9,4,30.77
2021-04-12 00:00:00.000,울산광역,14,8,5,9,64.29
2021-04-12 00:00:00.000,제주도,8,6,5,3,37.5
2021-04-12 00:00:00.000,서울시,7,5,3,4,57.14
2021-04-12 00:00:00.000,울,8,4,5,3,37.5
2021-04-12 00:00:00.000,기,7,3,3,4,57.14
2021-04-12 00:00:00.000,강북구,2,1,1,1,50
2021-04-12 00:00:00.000,광진구,1,1,1,0,0
2021-04-12 00:00:00.000,원,1,1,1,0,0
2021-04-12 00:00:00.000,남,2,1,2,0,0
2021-04-12 00:00:00.000,주,1,1,1,0,0
2021-04-12 00:00:00.000,산,2,1,2,0,0
2021-04-19 00:00:00.000,서울특별시,49350,31073,27842,21508,43.58
2021-04-19 00:00:00.000,경기도,18677,11389,10511,8166,43.72
2021-04-19 00:00:00.000,인천광역시,3080,1881,1700,1380,44.81
2021-04-19 00:00:00.000,서울,2275,1590,1333,942,41.41
2021-04-19 00:00:00.000,충청남도,2249,1383,1329,920,40.91
2021-04-19 00:00:00.000,경상북도,2097,1188,1171,926,44.16
2021-04-19 00:00:00.000,강원도,1746,1015,955,791,45.3
2021-04-19 00:00:00.000,경상남도,1675,922,880,795,47.46
2021-04-19 00:00:00.000,충청북도,1450,873,834,616,42.48
2021-04-19 00:00:00.000,,1117,851,706,411,36.79
2021-04-19 00:00:00.000,전라남도,1429,820,764,665,46.54
2021-04-19 00:00:00.000,전라북도,1352,732,681,671,49.63
2021-04-19 00:00:00.000,부산광역시,1346,721,687,659,48.96
2021-04-19 00:00:00.000,대전광역시,1073,609,570,503,46.88
2021-04-19 00:00:00.000,대구광역시,977,533,488,489,50.05
2021-04-19 00:00:00.000,경기,732,503,400,332,45.36
2021-04-19 00:00:00.000,광주광역시,768,453,434,334,43.49
2021-04-19 00:00:00.000,제주특별자치도,658,350,381,277,42.1
2021-04-19 00:00:00.000,울산광역시,531,301,261,270,50.85
2021-04-19 00:00:00.000,세종특별자치시,363,211,187,176,48.48
2021-04-19 00:00:00.000,인천광역,132,95,83,49,37.12
2021-04-19 00:00:00.000,충남,85,65,54,31,36.47
2021-04-19 00:00:00.000,경북,103,59,54,49,47.57
2021-04-19 00:00:00.000,인천,66,48,34,32,48.48
2021-04-19 00:00:00.000,전북,71,43,35,36,50.7
2021-04-19 00:00:00.000,충북,53,40,29,24,45.28
2021-04-19 00:00:00.000,경남,63,36,21,42,66.67
2021-04-19 00:00:00.000,강원,40,29,21,19,47.5
2021-04-19 00:00:00.000,부산광역,42,26,17,25,59.52
2021-04-19 00:00:00.000,대전광역,37,26,16,21,56.76
2021-04-19 00:00:00.000,★★★★★★★★,38,23,18,20,52.63
2021-04-19 00:00:00.000,대전,41,22,24,17,41.46
2021-04-19 00:00:00.000,전남,37,21,21,16,43.24
2021-04-19 00:00:00.000,대구,25,20,16,9,36
2021-04-19 00:00:00.000,광주,37,20,15,22,59.46
2021-04-19 00:00:00.000,광주광역,24,19,14,10,41.67
2021-04-19 00:00:00.000,부산,23,15,10,13,56.52
2021-04-19 00:00:00.000,대구광역,18,13,8,10,55.56
2021-04-19 00:00:00.000,울산,19,12,13,6,31.58
2021-04-19 00:00:00.000,제주도,16,9,8,8,50
2021-04-19 00:00:00.000,울,10,9,4,6,60
2021-04-19 00:00:00.000,제주,10,8,8,2,20
2021-04-19 00:00:00.000,울산광역,7,7,7,0,0
2021-04-19 00:00:00.000,서울시,5,4,3,2,40
2021-04-19 00:00:00.000,기,5,4,2,3,60
2021-04-19 00:00:00.000,남,5,3,1,4,80
2021-04-19 00:00:00.000,서울강북구,3,2,2,1,33.33
2021-04-19 00:00:00.000,원,3,2,2,1,33.33
2021-04-19 00:00:00.000,천,1,1,1,0,0
2021-04-19 00:00:00.000,세종시,2,1,2,0,0
2021-04-19 00:00:00.000,경기도양주군회천읍,1,1,0,1,100
2021-04-19 00:00:00.000,산,2,1,1,1,50
2021-04-19 00:00:00.000,주공아파트,1,1,1,0,0
2021-04-19 00:00:00.000,강북구,1,1,1,0,0
2021-04-26 00:00:00.000,서울특별시,48231,30358,27268,20963,43.46
2021-04-26 00:00:00.000,경기도,17799,11078,10193,7606,42.73
2021-04-26 00:00:00.000,인천광역시,2972,1762,1670,1302,43.81
2021-04-26 00:00:00.000,서울,2215,1568,1325,890,40.18
2021-04-26 00:00:00.000,충청남도,2124,1291,1179,945,44.49
2021-04-26 00:00:00.000,경상북도,1976,1130,1065,911,46.1
2021-04-26 00:00:00.000,강원도,1881,1064,995,886,47.1
2021-04-26 00:00:00.000,경상남도,1652,899,872,780,47.22
2021-04-26 00:00:00.000,,1067,837,700,367,34.4
2021-04-26 00:00:00.000,충청북도,1392,819,761,631,45.33
2021-04-26 00:00:00.000,전라북도,1351,764,752,599,44.34
2021-04-26 00:00:00.000,부산광역시,1429,739,696,733,51.29
2021-04-26 00:00:00.000,전라남도,1307,727,726,581,44.45
2021-04-26 00:00:00.000,대전광역시,1079,641,593,486,45.04
2021-04-26 00:00:00.000,경기,697,497,390,307,44.05
2021-04-26 00:00:00.000,대구광역시,854,491,467,387,45.32
2021-04-26 00:00:00.000,광주광역시,761,407,397,364,47.83
2021-04-26 00:00:00.000,제주특별자치도,713,385,408,305,42.78
2021-04-26 00:00:00.000,울산광역시,541,291,275,266,49.17
2021-04-26 00:00:00.000,세종특별자치시,340,198,186,154,45.29
2021-04-26 00:00:00.000,인천광역,132,90,75,57,43.18
2021-04-26 00:00:00.000,경남,87,53,49,38,43.68
2021-04-26 00:00:00.000,충남,72,53,42,30,41.67
2021-04-26 00:00:00.000,경북,91,52,49,42,46.15
2021-04-26 00:00:00.000,인천,64,42,37,27,42.19
2021-04-26 00:00:00.000,강원,61,39,33,28,45.9
2021-04-26 00:00:00.000,충북,48,33,30,18,37.5
2021-04-26 00:00:00.000,전북,33,26,18,15,45.45
2021-04-26 00:00:00.000,대전광역,35,25,20,15,42.86
2021-04-26 00:00:00.000,부산광역,34,24,21,13,38.24
2021-04-26 00:00:00.000,전남,33,23,14,19,57.58
2021-04-26 00:00:00.000,★★★★★★★★,32,23,21,11,34.38
2021-04-26 00:00:00.000,대전,27,22,18,9,33.33
2021-04-26 00:00:00.000,광주,39,22,21,18,46.15
2021-04-26 00:00:00.000,광주광역,27,20,14,13,48.15
2021-04-26 00:00:00.000,대구광역,29,19,14,15,51.72
2021-04-26 00:00:00.000,부산,28,17,15,13,46.43
2021-04-26 00:00:00.000,울,17,13,11,6,35.29
2021-04-26 00:00:00.000,서울강북구,14,10,11,3,21.43
2021-04-26 00:00:00.000,울산,18,9,9,9,50
2021-04-26 00:00:00.000,울산광역,14,8,5,9,64.29
2021-04-26 00:00:00.000,제주도,9,7,8,1,11.11
2021-04-26 00:00:00.000,대구,14,7,5,9,64.29
2021-04-26 00:00:00.000,제주,15,6,8,7,46.67
2021-04-26 00:00:00.000,기,11,6,4,7,63.64
2021-04-26 00:00:00.000,남,5,3,2,3,60
2021-04-26 00:00:00.000,서울시,2,2,1,1,50
2021-04-26 00:00:00.000,산,2,1,0,2,100
2021-04-26 00:00:00.000,강동구,1,1,1,0,0
2021-04-26 00:00:00.000,강북구,1,1,1,0,0
2021-04-26 00:00:00.000,전,1,1,1,0,0
2021-04-26 00:00:00.000,서울관악구봉천1동,1,1,1,0,0
2021-04-26 00:00:00.000,경기도화성시송산동,1,1,1,0,0
2021-04-26 00:00:00.000,경기용인시풍덕천2동,1,1,1,0,0
2021-04-26 00:00:00.000,강서구,3,1,0,3,100
2021-04-26 00:00:00.000,북,3,1,1,2,66.67
2021-05-03 00:00:00.000,서울특별시,41413,26584,22222,19191,46.34
2021-05-03 00:00:00.000,경기도,15314,9614,8232,7082,46.25
2021-05-03 00:00:00.000,인천광역시,2576,1562,1361,1215,47.17
2021-05-03 00:00:00.000,서울,1851,1355,1026,825,44.57
2021-05-03 00:00:00.000,충청남도,1805,1100,958,847,46.93
2021-05-03 00:00:00.000,경상북도,1727,964,882,845,48.93
2021-05-03 00:00:00.000,강원도,1415,870,717,698,49.33
2021-05-03 00:00:00.000,경상남도,1294,710,677,617,47.68
2021-05-03 00:00:00.000,충청북도,1143,705,603,540,47.24
2021-05-03 00:00:00.000,,895,699,618,277,30.95
2021-05-03 00:00:00.000,전라북도,1064,615,563,501,47.09
2021-05-03 00:00:00.000,전라남도,1021,598,531,490,47.99
2021-05-03 00:00:00.000,부산광역시,1093,572,544,549,50.23
2021-05-03 00:00:00.000,대전광역시,882,513,458,424,48.07
2021-05-03 00:00:00.000,대구광역시,742,419,355,387,52.16
2021-05-03 00:00:00.000,경기,611,416,310,301,49.26
2021-05-03 00:00:00.000,광주광역시,648,369,332,316,48.77
2021-05-03 00:00:00.000,제주특별자치도,513,265,276,237,46.2
2021-05-03 00:00:00.000,울산광역시,460,258,254,206,44.78
2021-05-03 00:00:00.000,세종특별자치시,345,196,180,165,47.83
2021-05-03 00:00:00.000,인천광역,122,82,64,58,47.54
2021-05-03 00:00:00.000,인천,61,41,30,31,50.82
2021-05-03 00:00:00.000,충남,55,40,28,27,49.09
2021-05-03 00:00:00.000,경북,56,35,35,21,37.5
2021-05-03 00:00:00.000,강원,44,31,25,19,43.18
2021-05-03 00:00:00.000,전북,46,30,23,23,50
2021-05-03 00:00:00.000,경남,32,23,16,16,50
2021-05-03 00:00:00.000,충북,30,22,14,16,53.33
2021-05-03 00:00:00.000,광주광역,33,20,16,17,51.52
2021-05-03 00:00:00.000,전남,27,18,19,8,29.63
2021-05-03 00:00:00.000,★★★★★★★★,30,18,17,13,43.33
2021-05-03 00:00:00.000,부산광역,26,17,11,15,57.69
2021-05-03 00:00:00.000,부산,20,13,12,8,40
2021-05-03 00:00:00.000,대구광역,14,12,12,2,14.29
2021-05-03 00:00:00.000,대전,20,12,4,16,80
2021-05-03 00:00:00.000,울산,22,10,10,12,54.55
2021-05-03 00:00:00.000,대전광역,16,10,6,10,62.5
2021-05-03 00:00:00.000,광주,13,9,9,4,30.77
2021-05-03 00:00:00.000,대구,18,9,7,11,61.11
2021-05-03 00:00:00.000,서울강북구,7,6,3,4,57.14
2021-05-03 00:00:00.000,제주도,8,6,6,2,25
2021-05-03 00:00:00.000,울산광역,10,5,5,5,50
2021-05-03 00:00:00.000,울,11,5,3,8,72.73
2021-05-03 00:00:00.000,기,5,4,5,0,0
2021-05-03 00:00:00.000,제주,5,4,3,2,40
2021-05-03 00:00:00.000,산,2,1,2,0,0
2021-05-03 00:00:00.000,남,1,1,1,0,0
2021-05-03 00:00:00.000,주,1,1,1,0,0
2021-05-03 00:00:00.000,인헌12다길,2,1,1,1,50
2021-05-03 00:00:00.000,강북구,2,1,0,2,100
2021-05-03 00:00:00.000,충부,2,1,0,2,100
2021-05-03 00:00:00.000,서울시,1,1,0,1,100
2021-05-03 00:00:00.000,원,1,1,1,0,0
2021-05-10 00:00:00.000,서울특별시,50989,32225,28698,22291,43.72
2021-05-10 00:00:00.000,경기도,18823,11627,10645,8178,43.45
2021-05-10 00:00:00.000,인천광역시,3196,1928,1753,1443,45.15
2021-05-10 00:00:00.000,서울,2368,1663,1373,995,42.02
2021-05-10 00:00:00.000,충청남도,2251,1364,1277,974,43.27
2021-05-10 00:00:00.000,경상북도,2131,1182,1140,991,46.5
2021-05-10 00:00:00.000,강원도,1775,1056,954,821,46.25
2021-05-10 00:00:00.000,경상남도,1635,897,845,790,48.32
2021-05-10 00:00:00.000,,1136,880,711,425,37.41
2021-05-10 00:00:00.000,충청북도,1364,824,782,582,42.67
2021-05-10 00:00:00.000,부산광역시,1426,773,711,715,50.14
2021-05-10 00:00:00.000,전라북도,1354,772,717,637,47.05
2021-05-10 00:00:00.000,전라남도,1262,710,677,585,46.35
2021-05-10 00:00:00.000,대전광역시,1171,673,620,551,47.05
2021-05-10 00:00:00.000,경기,775,555,442,333,42.97
2021-05-10 00:00:00.000,대구광역시,1025,541,515,510,49.76
2021-05-10 00:00:00.000,광주광역시,853,468,454,399,46.78
2021-05-10 00:00:00.000,제주특별자치도,667,376,363,304,45.58
2021-05-10 00:00:00.000,울산광역시,528,294,281,247,46.78
2021-05-10 00:00:00.000,세종특별자치시,372,222,235,137,36.83
2021-05-10 00:00:00.000,인천광역,110,84,62,48,43.64
2021-05-10 00:00:00.000,충남,88,63,46,42,47.73
2021-05-10 00:00:00.000,인천,92,61,47,45,48.91
2021-05-10 00:00:00.000,강원,61,44,39,22,36.07
2021-05-10 00:00:00.000,경북,56,41,33,23,41.07
2021-05-10 00:00:00.000,충북,61,40,37,24,39.34
2021-05-10 00:00:00.000,경남,62,37,27,35,56.45
2021-05-10 00:00:00.000,전북,47,34,29,18,38.3
2021-05-10 00:00:00.000,부산광역,42,29,29,13,30.95
2021-05-10 00:00:00.000,대전광역,51,28,21,30,58.82
2021-05-10 00:00:00.000,부산,46,25,21,25,54.35
2021-05-10 00:00:00.000,광주,39,23,16,23,58.97
2021-05-10 00:00:00.000,★★★★★★★★,28,19,20,8,28.57
2021-05-10 00:00:00.000,대구광역,27,18,15,12,44.44
2021-05-10 00:00:00.000,전남,28,17,16,12,42.86
2021-05-10 00:00:00.000,대전,24,17,16,8,33.33
2021-05-10 00:00:00.000,광주광역,16,13,7,9,56.25
2021-05-10 00:00:00.000,울산,18,12,6,12,66.67
2021-05-10 00:00:00.000,제주도,25,11,11,14,56
2021-05-10 00:00:00.000,울산광역,14,11,8,6,42.86
2021-05-10 00:00:00.000,대구,13,10,7,6,46.15
2021-05-10 00:00:00.000,서울강북구,11,10,10,1,9.09
2021-05-10 00:00:00.000,울,7,6,6,1,14.29
2021-05-10 00:00:00.000,제주,9,5,5,4,44.44
2021-05-10 00:00:00.000,남,6,5,5,1,16.67
2021-05-10 00:00:00.000,서울시,4,3,3,1,25
2021-05-10 00:00:00.000,북,3,2,1,2,66.67
2021-05-10 00:00:00.000,천,2,2,2,0,0
2021-05-10 00:00:00.000,산,2,2,0,2,100
2021-05-10 00:00:00.000,부산시,1,1,1,0,0
2021-05-10 00:00:00.000,전,2,1,0,2,100
2021-05-10 00:00:00.000,기,2,1,0,2,100
2021-05-10 00:00:00.000,광주시,2,1,1,1,50
2021-05-10 00:00:00.000,강서구,1,1,1,0,0
2021-05-17 00:00:00.000,서울특별시,41281,26739,22680,18601,45.06
2021-05-17 00:00:00.000,경기도,15023,9478,8213,6810,45.33
2021-05-17 00:00:00.000,인천광역시,2593,1591,1465,1128,43.5
2021-05-17 00:00:00.000,서울,1864,1346,1073,791,42.44
2021-05-17 00:00:00.000,충청남도,1944,1173,1068,876,45.06
2021-05-17 00:00:00.000,경상북도,1772,1007,921,851,48.02
2021-05-17 00:00:00.000,강원도,1429,852,744,685,47.94
2021-05-17 00:00:00.000,경상남도,1361,750,704,657,48.27
2021-05-17 00:00:00.000,,897,744,679,218,24.3
2021-05-17 00:00:00.000,충청북도,1157,714,660,497,42.96
2021-05-17 00:00:00.000,부산광역시,1179,651,577,602,51.06
2021-05-17 00:00:00.000,전라남도,1047,610,576,471,44.99
2021-05-17 00:00:00.000,전라북도,1113,609,554,559,50.22
2021-05-17 00:00:00.000,대전광역시,970,572,520,450,46.39
2021-05-17 00:00:00.000,대구광역시,794,450,412,382,48.11
2021-05-17 00:00:00.000,경기,623,446,328,295,47.35
2021-05-17 00:00:00.000,광주광역시,664,372,347,317,47.74
2021-05-17 00:00:00.000,제주특별자치도,508,296,266,242,47.64
2021-05-17 00:00:00.000,울산광역시,402,231,218,184,45.77
2021-05-17 00:00:00.000,세종특별자치시,287,179,159,128,44.6
2021-05-17 00:00:00.000,인천광역,84,60,46,38,45.24
2021-05-17 00:00:00.000,충남,87,50,46,41,47.13
2021-05-17 00:00:00.000,인천,64,44,25,39,60.94
2021-05-17 00:00:00.000,경북,55,32,26,29,52.73
2021-05-17 00:00:00.000,강원,46,31,25,21,45.65
2021-05-17 00:00:00.000,경남,43,31,27,16,37.21
2021-05-17 00:00:00.000,충북,40,28,23,17,42.5
2021-05-17 00:00:00.000,부산,37,24,19,18,48.65
2021-05-17 00:00:00.000,전북,38,23,20,18,47.37
2021-05-17 00:00:00.000,대전광역,34,20,18,16,47.06
2021-05-17 00:00:00.000,광주광역,27,19,17,10,37.04
2021-05-17 00:00:00.000,전남,23,17,15,8,34.78
2021-05-17 00:00:00.000,대전,26,16,14,12,46.15
2021-05-17 00:00:00.000,부산광역,21,15,8,13,61.9
2021-05-17 00:00:00.000,★★★★★★★★,18,15,8,10,55.56
2021-05-17 00:00:00.000,대구광역,17,15,12,5,29.41
2021-05-17 00:00:00.000,울산,16,11,11,5,31.25
2021-05-17 00:00:00.000,대구,16,10,5,11,68.75
2021-05-17 00:00:00.000,제주,17,9,5,12,70.59
2021-05-17 00:00:00.000,광주,14,9,10,4,28.57
2021-05-17 00:00:00.000,서울강북구,8,8,7,1,12.5
2021-05-17 00:00:00.000,제주도,11,8,6,5,45.45
2021-05-17 00:00:00.000,울산광역,7,5,4,3,42.86
2021-05-17 00:00:00.000,기,5,4,1,4,80
2021-05-17 00:00:00.000,울,6,4,4,2,33.33
2021-05-17 00:00:00.000,산,5,3,4,1,20
2021-05-17 00:00:00.000,서울관악구봉천1동,2,2,1,1,50
2021-05-17 00:00:00.000,서울시,4,2,0,4,100
2021-05-17 00:00:00.000,원주시,1,1,0,1,100
2021-05-17 00:00:00.000,강북구,1,1,1,0,0
2021-05-17 00:00:00.000,충부,1,1,1,0,0
2021-05-24 00:00:00.000,서울특별시,50990,31973,28428,22562,44.25
2021-05-24 00:00:00.000,경기도,18182,11363,10227,7955,43.75
2021-05-24 00:00:00.000,인천광역시,3347,1955,1832,1515,45.26
2021-05-24 00:00:00.000,서울,2312,1608,1347,965,41.74
2021-05-24 00:00:00.000,충청남도,2245,1354,1263,982,43.74
2021-05-24 00:00:00.000,경상북도,2086,1131,1080,1006,48.23
2021-05-24 00:00:00.000,강원도,1839,1072,1008,831,45.19
2021-05-24 00:00:00.000,경상남도,1751,914,884,867,49.51
2021-05-24 00:00:00.000,충청북도,1501,875,822,679,45.24
2021-05-24 00:00:00.000,,1078,838,732,346,32.1
2021-05-24 00:00:00.000,부산광역시,1413,789,774,639,45.22
2021-05-24 00:00:00.000,전라북도,1368,775,761,607,44.37
2021-05-24 00:00:00.000,전라남도,1313,715,707,606,46.15
2021-05-24 00:00:00.000,대전광역시,1110,648,615,495,44.59
2021-05-24 00:00:00.000,대구광역시,1008,538,551,457,45.34
2021-05-24 00:00:00.000,경기,780,533,444,336,43.08
2021-05-24 00:00:00.000,광주광역시,821,474,456,365,44.46
2021-05-24 00:00:00.000,제주특별자치도,702,384,370,332,47.29
2021-05-24 00:00:00.000,울산광역시,529,281,267,262,49.53
2021-05-24 00:00:00.000,세종특별자치시,375,231,207,168,44.8
2021-05-24 00:00:00.000,인천광역,123,89,64,59,47.97
2021-05-24 00:00:00.000,인천,105,65,58,47,44.76
2021-05-24 00:00:00.000,충남,75,51,45,30,40
2021-05-24 00:00:00.000,경북,81,47,42,39,48.15
2021-05-24 00:00:00.000,강원,50,40,33,17,34
2021-05-24 00:00:00.000,전북,61,39,41,20,32.79
2021-05-24 00:00:00.000,경남,50,32,26,24,48
2021-05-24 00:00:00.000,충북,49,30,26,23,46.94
2021-05-24 00:00:00.000,부산광역,48,27,26,22,45.83
2021-05-24 00:00:00.000,부산,33,24,15,18,54.55
2021-05-24 00:00:00.000,대전광역,34,24,16,18,52.94
2021-05-24 00:00:00.000,전남,34,22,22,12,35.29
2021-05-24 00:00:00.000,대전,40,22,16,24,60
2021-05-24 00:00:00.000,★★★★★★★★,26,19,7,19,73.08
2021-05-24 00:00:00.000,광주광역,34,18,14,20,58.82
2021-05-24 00:00:00.000,광주,25,18,20,5,20
2021-05-24 00:00:00.000,대구광역,25,16,12,13,52
2021-05-24 00:00:00.000,대구,21,14,12,9,42.86
2021-05-24 00:00:00.000,제주도,18,12,10,8,44.44
2021-05-24 00:00:00.000,제주,14,9,7,7,50
2021-05-24 00:00:00.000,울산광역,13,9,7,6,46.15
2021-05-24 00:00:00.000,울산,17,8,8,9,52.94
2021-05-24 00:00:00.000,울,9,7,6,3,33.33
2021-05-24 00:00:00.000,서울강북구,7,7,7,0,0
2021-05-24 00:00:00.000,서울시,6,4,2,4,66.67
2021-05-24 00:00:00.000,기,3,2,1,2,66.67
2021-05-24 00:00:00.000,남,6,2,2,4,66.67
2021-05-24 00:00:00.000,천,1,1,0,1,100
2021-05-24 00:00:00.000,원주시,1,1,1,0,0
2021-05-24 00:00:00.000,남동구만수2동,2,1,0,2,100
2021-05-24 00:00:00.000,전,1,1,1,0,0
2021-05-24 00:00:00.000,서울관악구봉천1동,1,1,1,0,0
2021-05-24 00:00:00.000,산,6,1,5,1,16.67
2021-05-24 00:00:00.000,원,2,1,2,0,0
2021-05-31 00:00:00.000,서울특별시,49725,31443,27419,22306,44.86
2021-05-31 00:00:00.000,경기도,18184,11218,10090,8094,44.51
2021-05-31 00:00:00.000,인천광역시,3119,1869,1735,1384,44.37
2021-05-31 00:00:00.000,서울,2298,1604,1295,1003,43.65
2021-05-31 00:00:00.000,충청남도,2089,1266,1165,924,44.23
2021-05-31 00:00:00.000,경상북도,2152,1199,1120,1032,47.96
2021-05-31 00:00:00.000,,1384,1149,736,648,46.82
2021-05-31 00:00:00.000,강원도,1739,1025,925,814,46.81
2021-05-31 00:00:00.000,경상남도,1706,883,873,833,48.83
2021-05-31 00:00:00.000,충청북도,1413,852,773,640,45.29
2021-05-31 00:00:00.000,전라북도,1286,730,693,593,46.11
2021-05-31 00:00:00.000,전라남도,1242,690,654,588,47.34
2021-05-31 00:00:00.000,부산광역시,1246,688,615,631,50.64
2021-05-31 00:00:00.000,대전광역시,1121,646,599,522,46.57
2021-05-31 00:00:00.000,경기,723,494,385,338,46.75
2021-05-31 00:00:00.000,대구광역시,915,487,446,469,51.26
2021-05-31 00:00:00.000,광주광역시,765,437,391,374,48.89
2021-05-31 00:00:00.000,제주특별자치도,708,363,375,333,47.03
2021-05-31 00:00:00.000,울산광역시,510,284,259,251,49.22
2021-05-31 00:00:00.000,세종특별자치시,428,233,233,195,45.56
2021-05-31 00:00:00.000,인천광역,140,92,75,65,46.43
2021-05-31 00:00:00.000,인천,81,57,49,32,39.51
2021-05-31 00:00:00.000,충남,76,52,44,32,42.11
2021-05-31 00:00:00.000,경북,62,41,33,29,46.77
2021-05-31 00:00:00.000,강원,58,40,35,23,39.66
2021-05-31 00:00:00.000,충북,40,31,21,19,47.5
2021-05-31 00:00:00.000,전북,51,29,20,31,60.78
2021-05-31 00:00:00.000,대전,40,22,25,15,37.5
2021-05-31 00:00:00.000,광주광역,31,22,14,17,54.84
2021-05-31 00:00:00.000,경남,29,21,14,15,51.72
2021-05-31 00:00:00.000,부산광역,33,20,16,17,51.52
2021-05-31 00:00:00.000,전남,27,20,9,18,66.67
2021-05-31 00:00:00.000,★★★★★★★★,22,19,9,13,59.09
2021-05-31 00:00:00.000,부산,27,18,16,11,40.74
2021-05-31 00:00:00.000,대전광역,20,17,12,8,40
2021-05-31 00:00:00.000,대구광역,29,17,19,10,34.48
2021-05-31 00:00:00.000,대구,26,16,16,10,38.46
2021-05-31 00:00:00.000,광주,18,12,6,12,66.67
2021-05-31 00:00:00.000,울산광역,18,12,11,7,38.89
2021-05-31 00:00:00.000,제주도,15,10,8,7,46.67
2021-05-31 00:00:00.000,제주,14,9,10,4,28.57
2021-05-31 00:00:00.000,울산,12,9,9,3,25
2021-05-31 00:00:00.000,서울강북구,10,8,5,5,50
2021-05-31 00:00:00.000,울,9,8,7,2,22.22
2021-05-31 00:00:00.000,기,7,4,4,3,42.86
2021-05-31 00:00:00.000,강북구,3,2,1,2,66.67
2021-05-31 00:00:00.000,경기도화성시송산동,3,2,2,1,33.33
2021-05-31 00:00:00.000,남,1,1,1,0,0
2021-05-31 00:00:00.000,남동구만수2동,1,1,1,0,0
2021-05-31 00:00:00.000,산,1,1,1,0,0
2021-05-31 00:00:00.000,서울시,1,1,0,1,100
2021-05-31 00:00:00.000,주,2,1,0,2,100
2021-05-31 00:00:00.000,경기용인시풍덕천2동,1,1,1,0,0
2021-05-31 00:00:00.000,서울관악구봉천1동,1,1,0,1,100
2021-05-31 00:00:00.000,광주시,2,1,0,2,100
2021-06-07 00:00:00.000,서울특별시,49715,31400,27367,22348,44.95
2021-06-07 00:00:00.000,경기도,18207,11173,9819,8388,46.07
2021-06-07 00:00:00.000,인천광역시,3085,1864,1703,1382,44.8
2021-06-07 00:00:00.000,서울,2268,1604,1324,944,41.62
2021-06-07 00:00:00.000,충청남도,2034,1213,1104,930,45.72
2021-06-07 00:00:00.000,경상북도,2032,1168,1081,951,46.8
2021-06-07 00:00:00.000,강원도,1715,992,880,835,48.69
2021-06-07 00:00:00.000,경상남도,1615,882,838,777,48.11
2021-06-07 00:00:00.000,,1104,877,737,367,33.24
2021-06-07 00:00:00.000,충청북도,1410,804,721,689,48.87
2021-06-07 00:00:00.000,전라남도,1388,744,702,686,49.42
2021-06-07 00:00:00.000,전라북도,1289,715,662,627,48.64
2021-06-07 00:00:00.000,부산광역시,1306,703,645,661,50.61
2021-06-07 00:00:00.000,대전광역시,1056,585,538,518,49.05
2021-06-07 00:00:00.000,대구광역시,964,515,489,475,49.27
2021-06-07 00:00:00.000,경기,646,476,381,265,41.02
2021-06-07 00:00:00.000,광주광역시,818,431,405,413,50.49
2021-06-07 00:00:00.000,제주특별자치도,659,345,318,341,51.75
2021-06-07 00:00:00.000,울산광역시,477,267,248,229,48.01
2021-06-07 00:00:00.000,세종특별자치시,395,212,218,177,44.81
2021-06-07 00:00:00.000,인천광역,96,69,62,34,35.42
2021-06-07 00:00:00.000,충남,87,60,55,32,36.78
2021-06-07 00:00:00.000,인천,81,56,45,36,44.44
2021-06-07 00:00:00.000,경북,69,47,41,28,40.58
2021-06-07 00:00:00.000,강원,66,46,37,29,43.94
2021-06-07 00:00:00.000,충북,38,27,19,19,50
2021-06-07 00:00:00.000,전북,31,22,21,10,32.26
2021-06-07 00:00:00.000,부산,36,21,11,25,69.44
2021-06-07 00:00:00.000,경남,31,21,16,15,48.39
2021-06-07 00:00:00.000,대전,33,20,14,19,57.58
2021-06-07 00:00:00.000,★★★★★★★★,24,19,15,9,37.5
2021-06-07 00:00:00.000,대전광역,23,17,11,12,52.17
2021-06-07 00:00:00.000,광주광역,20,16,10,10,50
2021-06-07 00:00:00.000,제주도,25,16,9,16,64
2021-06-07 00:00:00.000,전남,20,15,14,6,30
2021-06-07 00:00:00.000,부산광역,20,14,11,9,45
2021-06-07 00:00:00.000,광주,26,13,14,12,46.15
2021-06-07 00:00:00.000,대구,17,12,10,7,41.18
2021-06-07 00:00:00.000,울산,14,12,7,7,50
2021-06-07 00:00:00.000,대구광역,18,12,10,8,44.44
2021-06-07 00:00:00.000,서울강북구,16,12,11,5,31.25
2021-06-07 00:00:00.000,제주,9,8,7,2,22.22
2021-06-07 00:00:00.000,울,6,5,4,2,33.33
2021-06-07 00:00:00.000,울산광역,8,4,3,5,62.5
2021-06-07 00:00:00.000,서울시,5,3,0,5,100
2021-06-07 00:00:00.000,기,4,3,4,0,0
2021-06-07 00:00:00.000,주,2,2,2,0,0
2021-06-07 00:00:00.000,천,2,2,2,0,0
2021-06-07 00:00:00.000,인천직할시,3,1,0,3,100
2021-06-07 00:00:00.000,강북구,2,1,1,1,50
2021-06-07 00:00:00.000,서울관악구봉천1동,1,1,1,0,0
2021-06-07 00:00:00.000,남,1,1,1,0,0
2021-06-07 00:00:00.000,산,2,1,2,0,0
2021-06-07 00:00:00.000,광주시,1,1,1,0,0
2021-06-07 00:00:00.000,주공아파트,1,1,1,0,0
2021-06-14 00:00:00.000,서울특별시,50550,31906,28232,22318,44.15
2021-06-14 00:00:00.000,경기도,18773,11521,10447,8326,44.35
2021-06-14 00:00:00.000,인천광역시,3159,1884,1755,1404,44.44
2021-06-14 00:00:00.000,서울,2252,1610,1359,893,39.65
2021-06-14 00:00:00.000,충청남도,2193,1347,1227,966,44.05
2021-06-14 00:00:00.000,경상북도,2051,1139,1096,955,46.56
2021-06-14 00:00:00.000,강원도,1635,988,939,696,42.57
2021-06-14 00:00:00.000,,1147,875,734,413,36.01
2021-06-14 00:00:00.000,경상남도,1604,828,795,809,50.44
2021-06-14 00:00:00.000,충청북도,1390,811,788,602,43.31
2021-06-14 00:00:00.000,전라북도,1296,712,708,588,45.37
2021-06-14 00:00:00.000,전라남도,1256,686,671,585,46.58
2021-06-14 00:00:00.000,부산광역시,1279,686,671,608,47.54
2021-06-14 00:00:00.000,대전광역시,1165,629,610,555,47.64
2021-06-14 00:00:00.000,경기,750,529,420,330,44
2021-06-14 00:00:00.000,대구광역시,954,497,493,461,48.32
2021-06-14 00:00:00.000,광주광역시,806,432,400,406,50.37
2021-06-14 00:00:00.000,제주특별자치도,702,372,368,334,47.58
2021-06-14 00:00:00.000,울산광역시,540,290,274,266,49.26
2021-06-14 00:00:00.000,세종특별자치시,388,230,219,169,43.56
2021-06-14 00:00:00.000,인천광역,150,93,65,85,56.67
2021-06-14 00:00:00.000,인천,100,69,66,34,34
2021-06-14 00:00:00.000,경북,81,51,46,35,43.21
2021-06-14 00:00:00.000,충남,80,48,47,33,41.25
2021-06-14 00:00:00.000,경남,53,31,28,25,47.17
2021-06-14 00:00:00.000,강원,41,30,21,20,48.78
2021-06-14 00:00:00.000,전남,40,26,21,19,47.5
2021-06-14 00:00:00.000,충북,32,25,17,15,46.88
2021-06-14 00:00:00.000,전북,39,25,20,19,48.72
2021-06-14 00:00:00.000,대구광역,42,25,23,19,45.24
2021-06-14 00:00:00.000,대전,32,22,16,16,50
2021-06-14 00:00:00.000,부산,36,21,19,17,47.22
2021-06-14 00:00:00.000,부산광역,38,21,18,20,52.63
2021-06-14 00:00:00.000,대구,24,17,9,15,62.5
2021-06-14 00:00:00.000,대전광역,25,17,12,13,52
2021-06-14 00:00:00.000,★★★★★★★★,28,16,11,17,60.71
2021-06-14 00:00:00.000,광주광역,20,15,11,9,45
2021-06-14 00:00:00.000,제주도,31,14,14,17,54.84
2021-06-14 00:00:00.000,서울강북구,18,13,11,7,38.89
2021-06-14 00:00:00.000,울산광역,14,9,7,7,50
2021-06-14 00:00:00.000,울산,18,8,10,8,44.44
2021-06-14 00:00:00.000,광주,9,8,8,1,11.11
2021-06-14 00:00:00.000,울,6,6,4,2,33.33
2021-06-14 00:00:00.000,제주,8,5,5,3,37.5
2021-06-14 00:00:00.000,기,6,2,3,3,50
2021-06-14 00:00:00.000,서울시,2,2,1,1,50
2021-06-14 00:00:00.000,인천직할시,1,1,1,0,0
2021-06-14 00:00:00.000,강서구,1,1,1,0,0
2021-06-14 00:00:00.000,대동@,1,1,1,0,0
2021-06-14 00:00:00.000,북,1,1,1,0,0
2021-06-14 00:00:00.000,강북구,1,1,1,0,0
2021-06-14 00:00:00.000,광주시,2,1,1,1,50
2021-06-14 00:00:00.000,남,2,1,1,1,50
2021-06-14 00:00:00.000,광주동구소태동,1,1,1,0,0
2021-06-14 00:00:00.000,산,1,1,1,0,0
2021-06-14 00:00:00.000,주공아파트,1,1,1,0,0
2021-06-21 00:00:00.000,서울특별시,50843,32124,28496,22347,43.95
2021-06-21 00:00:00.000,경기도,18765,11660,10619,8146,43.41
2021-06-21 00:00:00.000,인천광역시,3051,1798,1672,1379,45.2
2021-06-21 00:00:00.000,서울,2291,1593,1367,924,40.33
2021-06-21 00:00:00.000,충청남도,2256,1378,1280,976,43.26
2021-06-21 00:00:00.000,경상북도,2055,1165,1097,958,46.62
2021-06-21 00:00:00.000,강원도,1868,1105,1013,855,45.77
2021-06-21 00:00:00.000,경상남도,1719,923,844,875,50.9
2021-06-21 00:00:00.000,충청북도,1477,869,829,648,43.87
2021-06-21 00:00:00.000,,1103,867,741,362,32.82
2021-06-21 00:00:00.000,전라남도,1299,752,695,604,46.5
2021-06-21 00:00:00.000,부산광역시,1334,747,699,635,47.6
2021-06-21 00:00:00.000,전라북도,1307,730,738,569,43.53
2021-06-21 00:00:00.000,대전광역시,1159,659,660,499,43.05
2021-06-21 00:00:00.000,대구광역시,988,538,526,462,46.76
2021-06-21 00:00:00.000,경기,733,521,429,304,41.47
2021-06-21 00:00:00.000,광주광역시,784,429,402,382,48.72
2021-06-21 00:00:00.000,제주특별자치도,687,373,363,324,47.16
2021-06-21 00:00:00.000,울산광역시,584,293,296,288,49.32
2021-06-21 00:00:00.000,세종특별자치시,403,229,213,190,47.15
2021-06-21 00:00:00.000,인천광역,109,80,71,38,34.86
2021-06-21 00:00:00.000,인천,70,50,39,31,44.29
2021-06-21 00:00:00.000,경북,67,50,39,28,41.79
2021-06-21 00:00:00.000,충남,70,47,36,34,48.57
2021-06-21 00:00:00.000,경남,61,39,24,37,60.66
2021-06-21 00:00:00.000,전북,69,38,37,32,46.38
2021-06-21 00:00:00.000,충북,56,38,39,17,30.36
2021-06-21 00:00:00.000,강원,43,33,26,17,39.53
2021-06-21 00:00:00.000,전남,39,28,20,19,48.72
2021-06-21 00:00:00.000,광주광역,34,24,18,16,47.06
2021-06-21 00:00:00.000,부산광역,31,21,13,18,58.06
2021-06-21 00:00:00.000,대전,29,19,24,5,17.24
2021-06-21 00:00:00.000,대구광역,25,19,15,10,40
2021-06-21 00:00:00.000,대전광역,21,18,14,7,33.33
2021-06-21 00:00:00.000,대구,24,16,12,12,50
2021-06-21 00:00:00.000,제주도,20,15,12,8,40
2021-06-21 00:00:00.000,광주,23,15,13,10,43.48
2021-06-21 00:00:00.000,★★★★★★★★,16,14,12,4,25
2021-06-21 00:00:00.000,울산,22,13,9,13,59.09
2021-06-21 00:00:00.000,부산,16,11,6,10,62.5
2021-06-21 00:00:00.000,서울강북구,18,10,7,11,61.11
2021-06-21 00:00:00.000,울산광역,11,8,7,4,36.36
2021-06-21 00:00:00.000,울,9,8,8,1,11.11
2021-06-21 00:00:00.000,제주,11,7,8,3,27.27
2021-06-21 00:00:00.000,기,4,4,3,1,25
2021-06-21 00:00:00.000,서울시,2,1,1,1,50
2021-06-21 00:00:00.000,산,1,1,0,1,100
2021-06-21 00:00:00.000,북,3,1,0,3,100
2021-06-21 00:00:00.000,남,1,1,0,1,100
2021-06-21 00:00:00.000,전,2,1,0,2,100
2021-06-21 00:00:00.000,경기도화성시송산동,1,1,0,1,100
2021-06-28 00:00:00.000,서울특별시,49123,31170,27006,22117,45.02
2021-06-28 00:00:00.000,경기도,18318,11323,10049,8269,45.14
2021-06-28 00:00:00.000,인천광역시,3223,1890,1704,1519,47.13
2021-06-28 00:00:00.000,서울,2365,1648,1373,992,41.95
2021-06-28 00:00:00.000,충청남도,2163,1284,1165,998,46.14
2021-06-28 00:00:00.000,경상북도,2039,1156,1079,960,47.08
2021-06-28 00:00:00.000,강원도,1718,1001,897,821,47.79
2021-06-28 00:00:00.000,,1170,876,831,339,28.97
2021-06-28 00:00:00.000,경상남도,1498,835,789,709,47.33
2021-06-28 00:00:00.000,충청북도,1354,814,795,559,41.29
2021-06-28 00:00:00.000,전라남도,1376,731,689,687,49.93
2021-06-28 00:00:00.000,부산광역시,1308,725,645,663,50.69
2021-06-28 00:00:00.000,전라북도,1185,690,643,542,45.74
2021-06-28 00:00:00.000,대전광역시,1093,618,569,524,47.94
2021-06-28 00:00:00.000,대구광역시,950,544,501,449,47.26
2021-06-28 00:00:00.000,경기,708,492,390,318,44.92
2021-06-28 00:00:00.000,광주광역시,733,402,391,342,46.66
2021-06-28 00:00:00.000,제주특별자치도,736,380,369,367,49.86
2021-06-28 00:00:00.000,울산광역시,463,260,253,210,45.36
2021-06-28 00:00:00.000,세종특별자치시,330,210,183,147,44.55
2021-06-28 00:00:00.000,인천광역,108,73,57,51,47.22
2021-06-28 00:00:00.000,인천,99,63,48,51,51.52
2021-06-28 00:00:00.000,충남,86,53,38,48,55.81
2021-06-28 00:00:00.000,경남,80,51,49,31,38.75
2021-06-28 00:00:00.000,경북,60,43,33,27,45
2021-06-28 00:00:00.000,강원,65,42,29,36,55.38
2021-06-28 00:00:00.000,전남,39,28,17,22,56.41
2021-06-28 00:00:00.000,광주광역,33,27,24,9,27.27
2021-06-28 00:00:00.000,전북,44,27,21,23,52.27
2021-06-28 00:00:00.000,부산광역,50,27,20,30,60
2021-06-28 00:00:00.000,★★★★★★★★,29,23,12,17,58.62
2021-06-28 00:00:00.000,대전광역,36,22,16,20,55.56
2021-06-28 00:00:00.000,광주,36,20,24,12,33.33
2021-06-28 00:00:00.000,충북,30,19,10,20,66.67
2021-06-28 00:00:00.000,부산,29,18,15,14,48.28
2021-06-28 00:00:00.000,대전,24,16,10,14,58.33
2021-06-28 00:00:00.000,울산,21,12,10,11,52.38
2021-06-28 00:00:00.000,대구,22,11,11,11,50
2021-06-28 00:00:00.000,서울강북구,15,11,9,6,40
2021-06-28 00:00:00.000,울산광역,14,10,7,7,50
2021-06-28 00:00:00.000,대구광역,10,9,6,4,40
2021-06-28 00:00:00.000,제주도,19,9,10,9,47.37
2021-06-28 00:00:00.000,울,9,8,5,4,44.44
2021-06-28 00:00:00.000,제주,11,6,7,4,36.36
2021-06-28 00:00:00.000,기,6,3,3,3,50
2021-06-28 00:00:00.000,서울시,2,2,1,1,50
2021-06-28 00:00:00.000,산,3,2,3,0,0
2021-06-28 00:00:00.000,남,5,2,2,3,60
2021-06-28 00:00:00.000,북,3,1,1,2,66.67
2021-06-28 00:00:00.000,주,1,1,1,0,0
2021-06-28 00:00:00.000,전,1,1,1,0,0
2021-07-05 00:00:00.000,서울특별시,50336,31928,27725,22611,44.92
2021-07-05 00:00:00.000,경기도,18012,11186,9988,8024,44.55
2021-07-05 00:00:00.000,인천광역시,3235,1942,1775,1460,45.13
2021-07-05 00:00:00.000,서울,2352,1651,1288,1064,45.24
2021-07-05 00:00:00.000,충청남도,2206,1314,1221,985,44.65
2021-07-05 00:00:00.000,경상북도,2061,1168,1108,953,46.24
2021-07-05 00:00:00.000,강원도,1646,983,865,781,47.45
2021-07-05 00:00:00.000,,1212,940,793,419,34.57
2021-07-05 00:00:00.000,경상남도,1533,857,788,745,48.6
2021-07-05 00:00:00.000,충청북도,1366,806,728,638,46.71
2021-07-05 00:00:00.000,전라북도,1330,769,720,610,45.86
2021-07-05 00:00:00.000,전라남도,1315,712,707,608,46.24
2021-07-05 00:00:00.000,부산광역시,1272,701,633,639,50.24
2021-07-05 00:00:00.000,대전광역시,1155,650,611,544,47.1
2021-07-05 00:00:00.000,대구광역시,959,544,480,479,49.95
2021-07-05 00:00:00.000,경기,726,523,403,323,44.49
2021-07-05 00:00:00.000,광주광역시,831,469,435,396,47.65
2021-07-05 00:00:00.000,제주특별자치도,637,338,342,295,46.31
2021-07-05 00:00:00.000,울산광역시,569,308,282,287,50.44
2021-07-05 00:00:00.000,세종특별자치시,387,237,208,179,46.25
2021-07-05 00:00:00.000,인천,89,64,48,41,46.07
2021-07-05 00:00:00.000,인천광역,80,63,47,33,41.25
2021-07-05 00:00:00.000,충남,88,62,51,37,42.05
2021-07-05 00:00:00.000,경북,75,53,46,29,38.67
2021-07-05 00:00:00.000,강원,68,46,46,22,32.35
2021-07-05 00:00:00.000,경남,57,40,27,30,52.63
2021-07-05 00:00:00.000,★★★★★★★★,40,31,23,17,42.5
2021-07-05 00:00:00.000,전남,42,31,22,20,47.62
2021-07-05 00:00:00.000,충북,31,28,23,8,25.81
2021-07-05 00:00:00.000,부산,37,25,17,20,54.05
2021-07-05 00:00:00.000,전북,40,24,27,13,32.5
2021-07-05 00:00:00.000,부산광역,35,24,20,15,42.86
2021-07-05 00:00:00.000,광주광역,35,23,15,20,57.14
2021-07-05 00:00:00.000,대전,32,21,17,15,46.88
2021-07-05 00:00:00.000,대전광역,30,20,17,13,43.33
2021-07-05 00:00:00.000,광주,24,18,19,5,20.83
2021-07-05 00:00:00.000,대구,28,17,13,15,53.57
2021-07-05 00:00:00.000,대구광역,25,16,10,15,60
2021-07-05 00:00:00.000,서울강북구,18,14,15,3,16.67
2021-07-05 00:00:00.000,울산,19,12,10,9,47.37
2021-07-05 00:00:00.000,울,11,10,7,4,36.36
2021-07-05 00:00:00.000,제주도,14,10,6,8,57.14
2021-07-05 00:00:00.000,제주,15,8,6,9,60
2021-07-05 00:00:00.000,울산광역,9,7,6,3,33.33
2021-07-05 00:00:00.000,기,8,6,7,1,12.5
2021-07-05 00:00:00.000,서울시,3,3,2,1,33.33
2021-07-05 00:00:00.000,남,4,2,2,2,50
2021-07-05 00:00:00.000,경기용인시풍덕천2동,1,1,1,0,0
2021-07-05 00:00:00.000,부산시,1,1,1,0,0
2021-07-05 00:00:00.000,인천직할시,1,1,0,1,100
2021-07-05 00:00:00.000,전남여수시여서동,3,1,1,2,66.67
2021-07-05 00:00:00.000,천,1,1,1,0,0
2021-07-05 00:00:00.000,서초구,1,1,0,1,100
2021-07-12 00:00:00.000,서울특별시,51588,32447,28779,22809,44.21
2021-07-12 00:00:00.000,경기도,18900,11667,10571,8329,44.07
2021-07-12 00:00:00.000,인천광역시,3304,1943,1708,1596,48.31
2021-07-12 00:00:00.000,서울,2367,1688,1380,987,41.7
2021-07-12 00:00:00.000,충청남도,2262,1323,1243,1019,45.05
2021-07-12 00:00:00.000,경상북도,1928,1095,1031,897,46.52
2021-07-12 00:00:00.000,강원도,1737,1023,953,784,45.14
2021-07-12 00:00:00.000,,1166,904,798,368,31.56
2021-07-12 00:00:00.000,경상남도,1653,903,846,807,48.82
2021-07-12 00:00:00.000,충청북도,1469,842,796,673,45.81
2021-07-12 00:00:00.000,전라남도,1425,791,748,677,47.51
2021-07-12 00:00:00.000,전라북도,1221,706,658,563,46.11
2021-07-12 00:00:00.000,부산광역시,1297,701,680,617,47.57
2021-07-12 00:00:00.000,대전광역시,1203,651,616,587,48.79
2021-07-12 00:00:00.000,대구광역시,883,514,453,430,48.7
2021-07-12 00:00:00.000,경기,702,494,372,330,47.01
2021-07-12 00:00:00.000,광주광역시,783,427,387,396,50.57
2021-07-12 00:00:00.000,제주특별자치도,668,350,357,311,46.56
2021-07-12 00:00:00.000,울산광역시,463,255,245,218,47.08
2021-07-12 00:00:00.000,세종특별자치시,369,211,184,185,50.14
2021-07-12 00:00:00.000,인천광역,114,82,62,52,45.61
2021-07-12 00:00:00.000,인천,71,53,47,24,33.8
2021-07-12 00:00:00.000,충남,78,53,40,38,48.72
2021-07-12 00:00:00.000,경북,59,39,30,29,49.15
2021-07-12 00:00:00.000,강원,64,37,29,35,54.69
2021-07-12 00:00:00.000,전북,43,29,22,21,48.84
2021-07-12 00:00:00.000,경남,41,27,23,18,43.9
2021-07-12 00:00:00.000,부산광역,38,26,15,23,60.53
2021-07-12 00:00:00.000,광주광역,47,25,22,25,53.19
2021-07-12 00:00:00.000,전남,42,25,18,24,57.14
2021-07-12 00:00:00.000,부산,37,24,13,24,64.86
2021-07-12 00:00:00.000,충북,28,23,20,8,28.57
2021-07-12 00:00:00.000,★★★★★★★★,23,19,13,10,43.48
2021-07-12 00:00:00.000,대전,26,18,16,10,38.46
2021-07-12 00:00:00.000,대전광역,22,17,14,8,36.36
2021-07-12 00:00:00.000,광주,29,16,10,19,65.52
2021-07-12 00:00:00.000,대구광역,19,15,13,6,31.58
2021-07-12 00:00:00.000,대구,17,14,12,5,29.41
2021-07-12 00:00:00.000,울산,14,11,8,6,42.86
2021-07-12 00:00:00.000,울,11,9,7,4,36.36
2021-07-12 00:00:00.000,제주,16,8,10,6,37.5
2021-07-12 00:00:00.000,서울강북구,9,8,6,3,33.33
2021-07-12 00:00:00.000,제주도,11,7,7,4,36.36
2021-07-12 00:00:00.000,울산광역,5,4,2,3,60
2021-07-12 00:00:00.000,서울시,3,3,1,2,66.67
2021-07-12 00:00:00.000,기,3,3,1,2,66.67
2021-07-12 00:00:00.000,강북구,2,2,2,0,0
2021-07-12 00:00:00.000,서대문구,1,1,1,0,0
2021-07-12 00:00:00.000,전,2,1,0,2,100
2021-07-12 00:00:00.000,남,1,1,1,0,0
2021-07-12 00:00:00.000,주공아파트,1,1,1,0,0
2021-07-19 00:00:00.000,서울특별시,52755,32548,29230,23525,44.59
2021-07-19 00:00:00.000,경기도,18788,11641,10475,8313,44.25
2021-07-19 00:00:00.000,인천광역시,3207,1908,1709,1498,46.71
2021-07-19 00:00:00.000,서울,2421,1662,1385,1036,42.79
2021-07-19 00:00:00.000,충청남도,2234,1309,1259,975,43.64
2021-07-19 00:00:00.000,경상북도,1984,1139,1019,965,48.64
2021-07-19 00:00:00.000,강원도,1721,1031,943,778,45.21
2021-07-19 00:00:00.000,,1172,938,784,388,33.11
2021-07-19 00:00:00.000,경상남도,1646,888,780,866,52.61
2021-07-19 00:00:00.000,충청북도,1483,861,841,642,43.29
2021-07-19 00:00:00.000,전라남도,1282,729,682,600,46.8
2021-07-19 00:00:00.000,전라북도,1248,718,663,585,46.88
2021-07-19 00:00:00.000,부산광역시,1421,718,709,712,50.11
2021-07-19 00:00:00.000,대전광역시,1162,669,625,537,46.21
2021-07-19 00:00:00.000,경기,747,523,418,329,44.04
2021-07-19 00:00:00.000,대구광역시,930,506,493,437,46.99
2021-07-19 00:00:00.000,광주광역시,801,443,412,389,48.56
2021-07-19 00:00:00.000,제주특별자치도,714,385,395,319,44.68
2021-07-19 00:00:00.000,울산광역시,536,279,282,254,47.39
2021-07-19 00:00:00.000,세종특별자치시,412,245,220,192,46.6
2021-07-19 00:00:00.000,인천광역,129,91,79,50,38.76
2021-07-19 00:00:00.000,인천,85,54,42,43,50.59
2021-07-19 00:00:00.000,충남,75,52,42,33,44
2021-07-19 00:00:00.000,경북,58,48,37,21,36.21
2021-07-19 00:00:00.000,충북,70,42,32,38,54.29
2021-07-19 00:00:00.000,강원,63,41,34,29,46.03
2021-07-19 00:00:00.000,경남,53,31,19,34,64.15
2021-07-19 00:00:00.000,부산,43,27,22,21,48.84
2021-07-19 00:00:00.000,전북,39,26,25,14,35.9
2021-07-19 00:00:00.000,★★★★★★★★,32,25,17,15,46.88
2021-07-19 00:00:00.000,광주광역,29,24,17,12,41.38
2021-07-19 00:00:00.000,대전,37,23,14,23,62.16
2021-07-19 00:00:00.000,부산광역,32,21,16,16,50
2021-07-19 00:00:00.000,광주,34,21,18,16,47.06
2021-07-19 00:00:00.000,대전광역,19,17,16,3,15.79
2021-07-19 00:00:00.000,전남,25,17,15,10,40
2021-07-19 00:00:00.000,제주,27,14,13,14,51.85
2021-07-19 00:00:00.000,대구광역,18,14,11,7,38.89
2021-07-19 00:00:00.000,울산광역,13,10,8,5,38.46
2021-07-19 00:00:00.000,제주도,13,9,7,6,46.15
2021-07-19 00:00:00.000,대구,18,9,8,10,55.56
2021-07-19 00:00:00.000,서울강북구,10,7,7,3,30
2021-07-19 00:00:00.000,울,7,7,6,1,14.29
2021-07-19 00:00:00.000,울산,7,5,5,2,28.57
2021-07-19 00:00:00.000,남,5,3,3,2,40
2021-07-19 00:00:00.000,서울시,2,2,1,1,50
2021-07-19 00:00:00.000,전,2,2,2,0,0
2021-07-19 00:00:00.000,강북구,2,2,2,0,0
2021-07-19 00:00:00.000,천,1,1,1,0,0
2021-07-19 00:00:00.000,전남여수시여서동,1,1,1,0,0
2021-07-19 00:00:00.000,기,1,1,1,0,0
2021-07-19 00:00:00.000,광주시,2,1,1,1,50
2021-07-19 00:00:00.000,서울관악구봉천1동,1,1,1,0,0
2021-07-19 00:00:00.000,북,3,1,1,2,66.67
2021-07-19 00:00:00.000,원,1,1,1,0,0
2021-07-26 00:00:00.000,서울특별시,49914,31213,27588,22326,44.73
2021-07-26 00:00:00.000,경기도,18269,11262,10148,8121,44.45
2021-07-26 00:00:00.000,인천광역시,3171,1913,1718,1453,45.82
2021-07-26 00:00:00.000,서울,2216,1603,1300,916,41.34
2021-07-26 00:00:00.000,충청남도,2195,1322,1168,1027,46.79
2021-07-26 00:00:00.000,경상북도,1937,1114,1021,916,47.29
2021-07-26 00:00:00.000,강원도,1752,1031,930,822,46.92
2021-07-26 00:00:00.000,,1161,893,762,399,34.37
2021-07-26 00:00:00.000,경상남도,1621,890,832,789,48.67
2021-07-26 00:00:00.000,충청북도,1376,822,769,607,44.11
2021-07-26 00:00:00.000,전라북도,1306,749,676,630,48.24
2021-07-26 00:00:00.000,부산광역시,1361,698,672,689,50.62
2021-07-26 00:00:00.000,대전광역시,1215,691,612,603,49.63
2021-07-26 00:00:00.000,전라남도,1223,685,647,576,47.1
2021-07-26 00:00:00.000,대구광역시,866,517,448,418,48.27
2021-07-26 00:00:00.000,경기,778,516,381,397,51.03
2021-07-26 00:00:00.000,광주광역시,766,442,376,390,50.91
2021-07-26 00:00:00.000,제주특별자치도,630,345,335,295,46.83
2021-07-26 00:00:00.000,울산광역시,497,281,264,233,46.88
2021-07-26 00:00:00.000,세종특별자치시,392,229,228,164,41.84
2021-07-26 00:00:00.000,인천광역,134,91,69,65,48.51
2021-07-26 00:00:00.000,인천,107,75,60,47,43.93
2021-07-26 00:00:00.000,충남,83,58,47,36,43.37
2021-07-26 00:00:00.000,충북,61,43,28,33,54.1
2021-07-26 00:00:00.000,강원,44,33,24,20,45.45
2021-07-26 00:00:00.000,경남,46,31,23,23,50
2021-07-26 00:00:00.000,★★★★★★★★,36,31,22,14,38.89
2021-07-26 00:00:00.000,경북,52,31,25,27,51.92
2021-07-26 00:00:00.000,부산광역,42,29,17,25,59.52
2021-07-26 00:00:00.000,광주광역,48,26,20,28,58.33
2021-07-26 00:00:00.000,대전광역,33,23,16,17,51.52
2021-07-26 00:00:00.000,전남,33,23,16,17,51.52
2021-07-26 00:00:00.000,대구광역,28,19,16,12,42.86
2021-07-26 00:00:00.000,부산,28,19,14,14,50
2021-07-26 00:00:00.000,전북,24,19,13,11,45.83
2021-07-26 00:00:00.000,대전,22,16,12,10,45.45
2021-07-26 00:00:00.000,대구,24,14,14,10,41.67
2021-07-26 00:00:00.000,광주,17,12,5,12,70.59
2021-07-26 00:00:00.000,제주도,13,8,6,7,53.85
2021-07-26 00:00:00.000,서울강북구,12,7,3,9,75
2021-07-26 00:00:00.000,울산,8,6,4,4,50
2021-07-26 00:00:00.000,울,7,6,5,2,28.57
2021-07-26 00:00:00.000,제주,10,5,4,6,60
2021-07-26 00:00:00.000,기,6,4,2,4,66.67
2021-07-26 00:00:00.000,서울시,3,3,0,3,100
2021-07-26 00:00:00.000,산,5,3,3,2,40
2021-07-26 00:00:00.000,울산광역,4,3,4,0,0
2021-07-26 00:00:00.000,남동구만수2동,2,1,1,1,50
2021-07-26 00:00:00.000,원,2,1,0,2,100
2021-07-26 00:00:00.000,남,1,1,1,0,0
2021-07-26 00:00:00.000,경기용인시풍덕천2동,1,1,1,0,0
2021-07-26 00:00:00.000,전,1,1,0,1,100
2021-07-26 00:00:00.000,강북구,2,1,1,1,50
2021-07-26 00:00:00.000,천,1,1,1,0,0
2021-08-02 00:00:00.000,서울특별시,49402,30855,26966,22436,45.42
2021-08-02 00:00:00.000,경기도,18450,11395,10001,8449,45.79
2021-08-02 00:00:00.000,인천광역시,3111,1882,1667,1444,46.42
2021-08-02 00:00:00.000,서울,2243,1573,1272,971,43.29
2021-08-02 00:00:00.000,충청남도,2392,1431,1258,1134,47.41
2021-08-02 00:00:00.000,경상북도,1904,1063,981,923,48.48
2021-08-02 00:00:00.000,경상남도,1812,987,894,918,50.66
2021-08-02 00:00:00.000,강원도,1595,922,855,740,46.39
2021-08-02 00:00:00.000,충청북도,1454,859,803,651,44.77
2021-08-02 00:00:00.000,,1148,852,740,408,35.54
2021-08-02 00:00:00.000,전라북도,1402,777,700,702,50.07
2021-08-02 00:00:00.000,전라남도,1242,708,621,621,50
2021-08-02 00:00:00.000,대전광역시,1219,687,638,581,47.66
2021-08-02 00:00:00.000,부산광역시,1238,657,634,604,48.79
2021-08-02 00:00:00.000,대구광역시,927,540,447,480,51.78
2021-08-02 00:00:00.000,경기,723,513,394,329,45.5
2021-08-02 00:00:00.000,광주광역시,889,489,440,449,50.51
2021-08-02 00:00:00.000,제주특별자치도,600,319,303,297,49.5
2021-08-02 00:00:00.000,울산광역시,495,283,245,250,50.51
2021-08-02 00:00:00.000,세종특별자치시,351,208,186,165,47.01
2021-08-02 00:00:00.000,인천광역,142,104,80,62,43.66
2021-08-02 00:00:00.000,인천,94,67,50,44,46.81
2021-08-02 00:00:00.000,충남,108,65,51,57,52.78
2021-08-02 00:00:00.000,경북,73,49,34,39,53.42
2021-08-02 00:00:00.000,충북,71,42,33,38,53.52
2021-08-02 00:00:00.000,강원,45,33,29,16,35.56
2021-08-02 00:00:00.000,부산,35,28,17,18,51.43
2021-08-02 00:00:00.000,전북,33,27,16,17,51.52
2021-08-02 00:00:00.000,부산광역,40,26,17,23,57.5
2021-08-02 00:00:00.000,★★★★★★★★,29,26,15,14,48.28
2021-08-02 00:00:00.000,경남,36,26,15,21,58.33
2021-08-02 00:00:00.000,광주광역,31,25,18,13,41.94
2021-08-02 00:00:00.000,대전광역,23,17,12,11,47.83
2021-08-02 00:00:00.000,광주,26,16,9,17,65.38
2021-08-02 00:00:00.000,대구광역,22,16,10,12,54.55
2021-08-02 00:00:00.000,대전,23,14,9,14,60.87
2021-08-02 00:00:00.000,전남,21,13,10,11,52.38
2021-08-02 00:00:00.000,제주,19,11,13,6,31.58
2021-08-02 00:00:00.000,대구,13,11,10,3,23.08
2021-08-02 00:00:00.000,울산광역,19,11,9,10,52.63
2021-08-02 00:00:00.000,울산,17,10,8,9,52.94
2021-08-02 00:00:00.000,제주도,8,6,5,3,37.5
2021-08-02 00:00:00.000,울,7,5,2,5,71.43
2021-08-02 00:00:00.000,서울시,8,5,3,5,62.5
2021-08-02 00:00:00.000,서울강북구,7,5,3,4,57.14
2021-08-02 00:00:00.000,산,5,3,3,2,40
2021-08-02 00:00:00.000,강북구,3,2,1,2,66.67
2021-08-02 00:00:00.000,남,1,1,0,1,100
2021-08-02 00:00:00.000,남동구만수2동,1,1,1,0,0
2021-08-02 00:00:00.000,북,1,1,1,0,0
2021-08-02 00:00:00.000,기,2,1,1,1,50
2021-08-02 00:00:00.000,원,1,1,1,0,0
2021-08-09 00:00:00.000,서울특별시,51129,32273,28620,22509,44.02
2021-08-09 00:00:00.000,경기도,18637,11624,10460,8177,43.88
2021-08-09 00:00:00.000,인천광역시,3310,1995,1789,1521,45.95
2021-08-09 00:00:00.000,서울,2342,1663,1357,985,42.06
2021-08-09 00:00:00.000,충청남도,2398,1442,1351,1047,43.66
2021-08-09 00:00:00.000,경상북도,1974,1163,1069,905,45.85
2021-08-09 00:00:00.000,강원도,1740,1005,888,852,48.97
2021-08-09 00:00:00.000,경상남도,1730,941,888,842,48.67
2021-08-09 00:00:00.000,,1155,925,808,347,30.04
2021-08-09 00:00:00.000,충청북도,1442,829,792,650,45.08
2021-08-09 00:00:00.000,전라남도,1307,748,668,639,48.89
2021-08-09 00:00:00.000,전라북도,1328,746,703,625,47.06
2021-08-09 00:00:00.000,부산광역시,1299,724,653,646,49.73
2021-08-09 00:00:00.000,대전광역시,1175,658,641,534,45.45
2021-08-09 00:00:00.000,대구광역시,978,582,523,455,46.52
2021-08-09 00:00:00.000,경기,773,552,426,347,44.89
2021-08-09 00:00:00.000,광주광역시,871,505,467,404,46.38
2021-08-09 00:00:00.000,제주특별자치도,698,387,364,334,47.85
2021-08-09 00:00:00.000,울산광역시,525,282,269,256,48.76
2021-08-09 00:00:00.000,세종특별자치시,431,239,243,188,43.62
2021-08-09 00:00:00.000,인천광역,140,93,73,67,47.86
2021-08-09 00:00:00.000,인천,90,62,49,41,45.56
2021-08-09 00:00:00.000,경북,74,50,39,35,47.3
2021-08-09 00:00:00.000,충남,84,48,33,51,60.71
2021-08-09 00:00:00.000,강원,55,43,40,15,27.27
2021-08-09 00:00:00.000,충북,56,37,32,24,42.86
2021-08-09 00:00:00.000,경남,54,37,32,22,40.74
2021-08-09 00:00:00.000,전북,44,32,26,18,40.91
2021-08-09 00:00:00.000,광주광역,44,31,29,15,34.09
2021-08-09 00:00:00.000,대전광역,37,27,19,18,48.65
2021-08-09 00:00:00.000,부산광역,36,26,18,18,50
2021-08-09 00:00:00.000,부산,32,24,21,11,34.38
2021-08-09 00:00:00.000,전남,26,22,15,11,42.31
2021-08-09 00:00:00.000,대전,30,21,22,8,26.67
2021-08-09 00:00:00.000,★★★★★★★★,25,20,18,7,28
2021-08-09 00:00:00.000,대구,24,16,13,11,45.83
2021-08-09 00:00:00.000,광주,26,15,8,18,69.23
2021-08-09 00:00:00.000,대구광역,20,14,10,10,50
2021-08-09 00:00:00.000,울산,13,11,11,2,15.38
2021-08-09 00:00:00.000,제주도,19,11,9,10,52.63
2021-08-09 00:00:00.000,울산광역,10,9,5,5,50
2021-08-09 00:00:00.000,울,10,7,6,4,40
2021-08-09 00:00:00.000,기,9,6,5,4,44.44
2021-08-09 00:00:00.000,서울강북구,8,6,5,3,37.5
2021-08-09 00:00:00.000,서울시,10,5,5,5,50
2021-08-09 00:00:00.000,강북구,2,2,2,0,0
2021-08-09 00:00:00.000,제주,7,2,5,2,28.57
2021-08-09 00:00:00.000,남,3,2,1,2,66.67
2021-08-09 00:00:00.000,주,4,1,0,4,100
2021-08-09 00:00:00.000,충부,1,1,0,1,100
2021-08-09 00:00:00.000,산,1,1,1,0,0
2021-08-09 00:00:00.000,원주시,2,1,0,2,100
2021-08-09 00:00:00.000,서울관악구봉천1동,1,1,1,0,0
2021-08-16 00:00:00.000,서울특별시,49456,30891,27482,21974,44.43
2021-08-16 00:00:00.000,경기도,18103,11274,9962,8141,44.97
2021-08-16 00:00:00.000,인천광역시,3106,1872,1669,1437,46.27
2021-08-16 00:00:00.000,서울,2243,1577,1290,953,42.49
2021-08-16 00:00:00.000,충청남도,2228,1312,1218,1010,45.33
2021-08-16 00:00:00.000,경상북도,1966,1137,1056,910,46.29
2021-08-16 00:00:00.000,강원도,1707,1035,935,772,45.23
2021-08-16 00:00:00.000,,1257,968,720,537,42.72
2021-08-16 00:00:00.000,경상남도,1676,928,812,864,51.55
2021-08-16 00:00:00.000,충청북도,1365,816,745,620,45.42
2021-08-16 00:00:00.000,전라남도,1382,775,690,692,50.07
2021-08-16 00:00:00.000,부산광역시,1419,732,689,730,51.44
2021-08-16 00:00:00.000,전라북도,1249,705,650,599,47.96
2021-08-16 00:00:00.000,대전광역시,1204,698,658,546,45.35
2021-08-16 00:00:00.000,대구광역시,923,537,497,426,46.15
2021-08-16 00:00:00.000,경기,714,513,391,323,45.24
2021-08-16 00:00:00.000,광주광역시,809,452,417,392,48.45
2021-08-16 00:00:00.000,제주특별자치도,634,337,317,317,50
2021-08-16 00:00:00.000,울산광역시,532,290,286,246,46.24
2021-08-16 00:00:00.000,세종특별자치시,384,220,224,160,41.67
2021-08-16 00:00:00.000,인천광역,124,92,64,60,48.39
2021-08-16 00:00:00.000,인천,82,57,55,27,32.93
2021-08-16 00:00:00.000,충남,73,51,44,29,39.73
2021-08-16 00:00:00.000,충북,83,49,37,46,55.42
2021-08-16 00:00:00.000,경북,57,38,39,18,31.58
2021-08-16 00:00:00.000,강원,59,38,26,33,55.93
2021-08-16 00:00:00.000,경남,46,32,28,18,39.13
2021-08-16 00:00:00.000,★★★★★★★★,35,28,25,10,28.57
2021-08-16 00:00:00.000,광주광역,36,25,22,14,38.89
2021-08-16 00:00:00.000,부산광역,35,24,13,22,62.86
2021-08-16 00:00:00.000,광주,32,20,15,17,53.13
2021-08-16 00:00:00.000,전북,29,20,18,11,37.93
2021-08-16 00:00:00.000,전남,30,19,17,13,43.33
2021-08-16 00:00:00.000,대전광역,28,19,14,14,50
2021-08-16 00:00:00.000,부산,28,19,16,12,42.86
2021-08-16 00:00:00.000,대전,36,18,14,22,61.11
2021-08-16 00:00:00.000,대구광역,16,13,9,7,43.75
2021-08-16 00:00:00.000,제주도,17,11,10,7,41.18
2021-08-16 00:00:00.000,대구,13,11,11,2,15.38
2021-08-16 00:00:00.000,울,15,10,10,5,33.33
2021-08-16 00:00:00.000,제주,8,8,8,0,0
2021-08-16 00:00:00.000,울산,10,7,4,6,60
2021-08-16 00:00:00.000,서울강북구,5,5,3,2,40
2021-08-16 00:00:00.000,기,4,3,3,1,25
2021-08-16 00:00:00.000,울산광역,3,3,1,2,66.67
2021-08-16 00:00:00.000,서울시,3,2,0,3,100
2021-08-16 00:00:00.000,북,1,1,1,0,0
2021-08-16 00:00:00.000,기도,1,1,1,0,0
2021-08-16 00:00:00.000,주,1,1,1,0,0
2021-08-16 00:00:00.000,산,3,1,0,3,100
2021-08-16 00:00:00.000,원,2,1,1,1,50
2021-08-16 00:00:00.000,남,1,1,1,0,0
2021-08-23 00:00:00.000,서울특별시,50622,31491,27870,22752,44.94
2021-08-23 00:00:00.000,경기도,17925,11153,10078,7847,43.78
2021-08-23 00:00:00.000,인천광역시,3038,1779,1613,1425,46.91
2021-08-23 00:00:00.000,서울,2275,1601,1306,969,42.59
2021-08-23 00:00:00.000,충청남도,2200,1303,1231,969,44.05
2021-08-23 00:00:00.000,경상북도,2131,1167,1125,1006,47.21
2021-08-23 00:00:00.000,강원도,1706,1012,907,799,46.83
2021-08-23 00:00:00.000,경상남도,1686,932,876,810,48.04
2021-08-23 00:00:00.000,,1188,911,761,427,35.94
2021-08-23 00:00:00.000,충청북도,1402,804,750,652,46.5
2021-08-23 00:00:00.000,전라남도,1388,744,709,679,48.92
2021-08-23 00:00:00.000,부산광역시,1374,742,705,669,48.69
2021-08-23 00:00:00.000,전라북도,1226,701,617,609,49.67
2021-08-23 00:00:00.000,대전광역시,1198,687,632,566,47.25
2021-08-23 00:00:00.000,경기,695,510,405,290,41.73
2021-08-23 00:00:00.000,대구광역시,907,510,424,483,53.25
2021-08-23 00:00:00.000,광주광역시,781,442,410,371,47.5
2021-08-23 00:00:00.000,제주특별자치도,642,343,335,307,47.82
2021-08-23 00:00:00.000,울산광역시,477,271,260,217,45.49
2021-08-23 00:00:00.000,세종특별자치시,360,200,209,151,41.94
2021-08-23 00:00:00.000,인천광역,129,93,79,50,38.76
2021-08-23 00:00:00.000,인천,70,53,43,27,38.57
2021-08-23 00:00:00.000,충남,82,52,44,38,46.34
2021-08-23 00:00:00.000,경북,62,45,30,32,51.61
2021-08-23 00:00:00.000,경남,68,43,38,30,44.12
2021-08-23 00:00:00.000,강원,61,43,35,26,42.62
2021-08-23 00:00:00.000,충북,48,35,32,16,33.33
2021-08-23 00:00:00.000,전북,44,27,22,22,50
2021-08-23 00:00:00.000,부산광역,39,20,18,21,53.85
2021-08-23 00:00:00.000,대전,28,20,15,13,46.43
2021-08-23 00:00:00.000,부산,23,19,14,9,39.13
2021-08-23 00:00:00.000,★★★★★★★★,21,17,12,9,42.86
2021-08-23 00:00:00.000,광주,25,17,13,12,48
2021-08-23 00:00:00.000,전남,28,16,18,10,35.71
2021-08-23 00:00:00.000,대구,24,14,10,14,58.33
2021-08-23 00:00:00.000,대전광역,18,13,7,11,61.11
2021-08-23 00:00:00.000,대구광역,21,12,10,11,52.38
2021-08-23 00:00:00.000,광주광역,16,11,7,9,56.25
2021-08-23 00:00:00.000,제주도,18,10,8,10,55.56
2021-08-23 00:00:00.000,울산,14,8,5,9,64.29
2021-08-23 00:00:00.000,울산광역,12,8,7,5,41.67
2021-08-23 00:00:00.000,제주,12,6,6,6,50
2021-08-23 00:00:00.000,서울강북구,6,4,3,3,50
2021-08-23 00:00:00.000,울,4,4,4,0,0
2021-08-23 00:00:00.000,서울시,7,4,4,3,42.86
2021-08-23 00:00:00.000,기,3,2,0,3,100
2021-08-23 00:00:00.000,산,4,2,4,0,0
2021-08-23 00:00:00.000,남,1,1,1,0,0
2021-08-23 00:00:00.000,광주시,2,1,1,1,50
2021-08-23 00:00:00.000,북,2,1,0,2,100
2021-08-23 00:00:00.000,원주시,2,1,0,2,100
2021-08-30 00:00:00.000,서울특별시,50805,31996,28431,22374,44.04
2021-08-30 00:00:00.000,경기도,17657,11192,9827,7830,44.35
2021-08-30 00:00:00.000,인천광역시,3150,1867,1675,1475,46.83
2021-08-30 00:00:00.000,서울,2202,1579,1264,938,42.6
2021-08-30 00:00:00.000,충청남도,2100,1285,1234,866,41.24
2021-08-30 00:00:00.000,경상북도,1937,1092,976,961,49.61
2021-08-30 00:00:00.000,강원도,1597,983,866,731,45.77
2021-08-30 00:00:00.000,경상남도,1633,911,840,793,48.56
2021-08-30 00:00:00.000,,1082,845,707,375,34.66
2021-08-30 00:00:00.000,충청북도,1285,785,705,580,45.14
2021-08-30 00:00:00.000,부산광역시,1354,744,700,654,48.3
2021-08-30 00:00:00.000,전라남도,1284,734,665,619,48.21
2021-08-30 00:00:00.000,전라북도,1244,732,646,598,48.07
2021-08-30 00:00:00.000,대전광역시,1172,679,657,515,43.94
2021-08-30 00:00:00.000,대구광역시,943,560,479,464,49.2
2021-08-30 00:00:00.000,경기,684,498,396,288,42.11
2021-08-30 00:00:00.000,광주광역시,766,417,369,397,51.83
2021-08-30 00:00:00.000,제주특별자치도,638,374,333,305,47.81
2021-08-30 00:00:00.000,울산광역시,487,261,232,255,52.36
2021-08-30 00:00:00.000,세종특별자치시,355,215,202,153,43.1
2021-08-30 00:00:00.000,인천광역,120,91,72,48,40
2021-08-30 00:00:00.000,충남,79,53,39,40,50.63
2021-08-30 00:00:00.000,인천,64,52,39,25,39.06
2021-08-30 00:00:00.000,경북,55,38,31,24,43.64
2021-08-30 00:00:00.000,강원,46,35,25,21,45.65
2021-08-30 00:00:00.000,충북,46,31,28,18,39.13
2021-08-30 00:00:00.000,전북,37,31,23,14,37.84
2021-08-30 00:00:00.000,경남,39,27,21,18,46.15
2021-08-30 00:00:00.000,광주광역,33,22,19,14,42.42
2021-08-30 00:00:00.000,★★★★★★★★,23,21,16,7,30.43
2021-08-30 00:00:00.000,대전광역,28,20,13,15,53.57
2021-08-30 00:00:00.000,부산,28,19,15,13,46.43
2021-08-30 00:00:00.000,전남,25,17,19,6,24
2021-08-30 00:00:00.000,부산광역,22,15,7,15,68.18
2021-08-30 00:00:00.000,대전,24,14,15,9,37.5
2021-08-30 00:00:00.000,대구,23,14,9,14,60.87
2021-08-30 00:00:00.000,대구광역,14,13,9,5,35.71
2021-08-30 00:00:00.000,광주,15,12,12,3,20
2021-08-30 00:00:00.000,제주도,18,12,8,10,55.56
2021-08-30 00:00:00.000,서울강북구,11,10,8,3,27.27
2021-08-30 00:00:00.000,울,13,10,9,4,30.77
2021-08-30 00:00:00.000,울산,10,8,6,4,40
2021-08-30 00:00:00.000,제주,15,6,9,6,40
2021-08-30 00:00:00.000,기,4,4,3,1,25
2021-08-30 00:00:00.000,남,7,4,3,4,57.14
2021-08-30 00:00:00.000,서울시,3,2,1,2,66.67
2021-08-30 00:00:00.000,북,2,2,2,0,0
2021-08-30 00:00:00.000,울산광역,3,2,2,1,33.33
2021-08-30 00:00:00.000,천,6,2,1,5,83.33
2021-08-30 00:00:00.000,주,1,1,1,0,0
2021-08-30 00:00:00.000,원주시,1,1,1,0,0
2021-08-30 00:00:00.000,경기도화성시송산동,1,1,0,1,100
2021-08-30 00:00:00.000,원,1,1,1,0,0
2021-08-30 00:00:00.000,주공APT,1,1,1,0,0
2021-09-06 00:00:00.000,서울특별시,54477,33535,29497,24980,45.85
2021-09-06 00:00:00.000,경기도,19184,11655,10336,8848,46.12
2021-09-06 00:00:00.000,인천광역시,3224,1931,1719,1505,46.68
2021-09-06 00:00:00.000,서울,2437,1690,1337,1100,45.14
2021-09-06 00:00:00.000,충청남도,2387,1391,1296,1091,45.71
2021-09-06 00:00:00.000,경상북도,2100,1163,1088,1012,48.19
2021-09-06 00:00:00.000,강원도,1713,1021,944,769,44.89
2021-09-06 00:00:00.000,경상남도,1726,923,872,854,49.48
2021-09-06 00:00:00.000,,1135,894,744,391,34.45
2021-09-06 00:00:00.000,충청북도,1398,814,757,641,45.85
2021-09-06 00:00:00.000,전라남도,1434,740,740,694,48.4
2021-09-06 00:00:00.000,부산광역시,1407,729,725,682,48.47
2021-09-06 00:00:00.000,전라북도,1407,728,710,697,49.54
2021-09-06 00:00:00.000,대전광역시,1265,689,619,646,51.07
2021-09-06 00:00:00.000,대구광역시,959,543,497,462,48.18
2021-09-06 00:00:00.000,경기,791,535,445,346,43.74
2021-09-06 00:00:00.000,광주광역시,922,491,480,442,47.94
2021-09-06 00:00:00.000,제주특별자치도,701,374,343,358,51.07
2021-09-06 00:00:00.000,울산광역시,587,316,283,304,51.79
2021-09-06 00:00:00.000,세종특별자치시,443,240,240,203,45.82
2021-09-06 00:00:00.000,인천광역,116,94,69,47,40.52
2021-09-06 00:00:00.000,인천,78,54,40,38,48.72
2021-09-06 00:00:00.000,강원,70,49,36,34,48.57
2021-09-06 00:00:00.000,경남,75,45,39,36,48
2021-09-06 00:00:00.000,충남,70,44,31,39,55.71
2021-09-06 00:00:00.000,경북,52,33,28,24,46.15
2021-09-06 00:00:00.000,전북,48,30,24,24,50
2021-09-06 00:00:00.000,충북,40,29,24,16,40
2021-09-06 00:00:00.000,부산광역,31,25,18,13,41.94
2021-09-06 00:00:00.000,★★★★★★★★,23,19,13,10,43.48
2021-09-06 00:00:00.000,부산,29,19,15,14,48.28
2021-09-06 00:00:00.000,대구,32,19,19,13,40.63
2021-09-06 00:00:00.000,대전광역,28,19,11,17,60.71
2021-09-06 00:00:00.000,전남,37,19,20,17,45.95
2021-09-06 00:00:00.000,대전,30,18,13,17,56.67
2021-09-06 00:00:00.000,광주광역,21,17,14,7,33.33
2021-09-06 00:00:00.000,대구광역,20,16,14,6,30
2021-09-06 00:00:00.000,광주,14,11,10,4,28.57
2021-09-06 00:00:00.000,제주도,14,11,11,3,21.43
2021-09-06 00:00:00.000,울산,9,8,7,2,22.22
2021-09-06 00:00:00.000,울,9,7,9,0,0
2021-09-06 00:00:00.000,울산광역,6,5,5,1,16.67
2021-09-06 00:00:00.000,서울강북구,7,5,3,4,57.14
2021-09-06 00:00:00.000,제주,11,4,4,7,63.64
2021-09-06 00:00:00.000,남,7,4,4,3,42.86
2021-09-06 00:00:00.000,서울시,4,3,3,1,25
2021-09-06 00:00:00.000,기,5,3,1,4,80
2021-09-06 00:00:00.000,천,3,2,3,0,0
2021-09-06 00:00:00.000,주,2,1,0,2,100
2021-09-06 00:00:00.000,북,1,1,1,0,0
2021-09-06 00:00:00.000,서울관악구봉천1동,1,1,1,0,0
2021-09-06 00:00:00.000,서대문구,1,1,1,0,0
2021-09-06 00:00:00.000,전,4,1,2,2,50
2021-09-13 00:00:00.000,서울특별시,55678,34207,31830,23848,42.83
2021-09-13 00:00:00.000,경기도,19836,12173,11102,8734,44.03
2021-09-13 00:00:00.000,인천광역시,3529,2073,2023,1506,42.67
2021-09-13 00:00:00.000,서울,2508,1775,1507,1001,39.91
2021-09-13 00:00:00.000,충청남도,2318,1376,1279,1039,44.82
2021-09-13 00:00:00.000,경상북도,2192,1182,1130,1062,48.45
2021-09-13 00:00:00.000,강원도,1856,1102,994,862,46.44
2021-09-13 00:00:00.000,,1266,1017,767,499,39.42
2021-09-13 00:00:00.000,경상남도,1827,953,947,880,48.17
2021-09-13 00:00:00.000,충청북도,1405,838,819,586,41.71
2021-09-13 00:00:00.000,부산광역시,1485,753,772,713,48.01
2021-09-13 00:00:00.000,전라남도,1380,741,753,627,45.43
2021-09-13 00:00:00.000,대전광역시,1219,695,688,531,43.56
2021-09-13 00:00:00.000,전라북도,1254,694,675,579,46.17
2021-09-13 00:00:00.000,대구광역시,952,532,537,415,43.59
2021-09-13 00:00:00.000,경기,747,520,458,289,38.69
2021-09-13 00:00:00.000,광주광역시,871,458,442,429,49.25
2021-09-13 00:00:00.000,제주특별자치도,669,354,322,347,51.87
2021-09-13 00:00:00.000,울산광역시,517,281,296,221,42.75
2021-09-13 00:00:00.000,세종특별자치시,431,234,237,194,45.01
2021-09-13 00:00:00.000,인천광역,135,99,87,48,35.56
2021-09-13 00:00:00.000,인천,91,60,52,39,42.86
2021-09-13 00:00:00.000,충남,76,49,46,30,39.47
2021-09-13 00:00:00.000,경북,65,47,41,24,36.92
2021-09-13 00:00:00.000,강원,54,43,30,24,44.44
2021-09-13 00:00:00.000,경남,59,38,37,22,37.29
2021-09-13 00:00:00.000,전북,51,29,33,18,35.29
2021-09-13 00:00:00.000,충북,36,25,23,13,36.11
2021-09-13 00:00:00.000,대전,33,23,21,12,36.36
2021-09-13 00:00:00.000,★★★★★★★★,29,21,19,10,34.48
2021-09-13 00:00:00.000,대전광역,35,21,12,23,65.71
2021-09-13 00:00:00.000,광주광역,24,18,14,10,41.67
2021-09-13 00:00:00.000,대구광역,26,16,13,13,50
2021-09-13 00:00:00.000,부산,23,15,9,14,60.87
2021-09-13 00:00:00.000,광주,27,14,13,14,51.85
2021-09-13 00:00:00.000,전남,28,14,19,9,32.14
2021-09-13 00:00:00.000,부산광역,23,13,15,8,34.78
2021-09-13 00:00:00.000,대구,13,10,10,3,23.08
2021-09-13 00:00:00.000,서울강북구,12,10,8,4,33.33
2021-09-13 00:00:00.000,제주,19,9,8,11,57.89
2021-09-13 00:00:00.000,울,9,8,5,4,44.44
2021-09-13 00:00:00.000,울산,7,6,6,1,14.29
2021-09-13 00:00:00.000,제주도,10,5,5,5,50
2021-09-13 00:00:00.000,울산광역,7,5,4,3,42.86
2021-09-13 00:00:00.000,북,8,4,2,6,75
2021-09-13 00:00:00.000,서울시,7,3,1,6,85.71
2021-09-13 00:00:00.000,기,3,3,2,1,33.33
2021-09-13 00:00:00.000,산,2,2,2,0,0
2021-09-13 00:00:00.000,경기도화성시송산동,2,2,2,0,0
2021-09-13 00:00:00.000,원,2,2,1,1,50
2021-09-13 00:00:00.000,서울강북구번3동,1,1,1,0,0
2021-09-13 00:00:00.000,주,1,1,1,0,0
2021-09-13 00:00:00.000,경기의왕시포일동,2,1,1,1,50
2021-09-20 00:00:00.000,서울특별시,24555,16216,12243,12312,50.14
2021-09-20 00:00:00.000,경기도,8581,5660,4362,4219,49.17
2021-09-20 00:00:00.000,인천광역시,1472,901,711,761,51.7
2021-09-20 00:00:00.000,서울,1047,768,551,496,47.37
2021-09-20 00:00:00.000,충청남도,900,564,438,462,51.33
2021-09-20 00:00:00.000,경상북도,785,494,371,414,52.74
2021-09-20 00:00:00.000,강원도,775,480,382,393,50.71
2021-09-20 00:00:00.000,경상남도,735,408,335,400,54.42
2021-09-20 00:00:00.000,충청북도,635,401,304,331,52.13
2021-09-20 00:00:00.000,부산광역시,575,332,271,304,52.87
2021-09-20 00:00:00.000,,429,327,248,181,42.19
2021-09-20 00:00:00.000,전라북도,555,323,226,329,59.28
2021-09-20 00:00:00.000,전라남도,562,302,240,322,57.3
2021-09-20 00:00:00.000,대전광역시,497,287,234,263,52.92
2021-09-20 00:00:00.000,대구광역시,350,221,160,190,54.29
2021-09-20 00:00:00.000,경기,292,210,160,132,45.21
2021-09-20 00:00:00.000,광주광역시,358,208,148,210,58.66
2021-09-20 00:00:00.000,제주특별자치도,253,140,135,118,46.64
2021-09-20 00:00:00.000,울산광역시,204,106,96,108,52.94
2021-09-20 00:00:00.000,세종특별자치시,166,103,90,76,45.78
2021-09-20 00:00:00.000,인천광역,44,33,18,26,59.09
2021-09-20 00:00:00.000,인천,27,17,16,11,40.74
2021-09-20 00:00:00.000,충남,27,16,10,17,62.96
2021-09-20 00:00:00.000,경북,25,16,11,14,56
2021-09-20 00:00:00.000,강원,23,16,12,11,47.83
2021-09-20 00:00:00.000,경남,21,14,9,12,57.14
2021-09-20 00:00:00.000,전북,19,11,7,12,63.16
2021-09-20 00:00:00.000,부산,10,8,8,2,20
2021-09-20 00:00:00.000,광주광역,13,8,4,9,69.23
2021-09-20 00:00:00.000,광주,8,7,7,1,12.5
2021-09-20 00:00:00.000,대전광역,10,7,8,2,20
2021-09-20 00:00:00.000,대구광역,7,6,6,1,14.29
2021-09-20 00:00:00.000,부산광역,9,6,2,7,77.78
2021-09-20 00:00:00.000,전남,9,6,4,5,55.56
2021-09-20 00:00:00.000,울산,10,5,6,4,40
2021-09-20 00:00:00.000,대전,6,5,4,2,33.33
2021-09-20 00:00:00.000,충북,7,5,5,2,28.57
2021-09-20 00:00:00.000,★★★★★★★★,5,5,3,2,40
2021-09-20 00:00:00.000,대구,8,5,4,4,50
2021-09-20 00:00:00.000,서울강북구,5,4,2,3,60
2021-09-20 00:00:00.000,울,5,4,2,3,60
2021-09-20 00:00:00.000,울산광역,5,3,2,3,60
2021-09-20 00:00:00.000,제주도,11,3,6,5,45.45
2021-09-20 00:00:00.000,제주,3,2,2,1,33.33
2021-09-20 00:00:00.000,남,1,1,0,1,100
2021-09-20 00:00:00.000,서울시,2,1,1,1,50
2021-09-20 00:00:00.000,북,1,1,1,0,0
2021-09-20 00:00:00.000,기,1,1,1,0,0
2021-09-20 00:00:00.000,서울강북구번3동,2,1,1,1,50
2021-09-27 00:00:00.000,서울특별시,43807,28840,25825,17982,41.05
2021-09-27 00:00:00.000,경기도,15978,10205,9321,6657,41.66
2021-09-27 00:00:00.000,인천광역시,2772,1730,1624,1148,41.41
2021-09-27 00:00:00.000,서울,1973,1412,1211,762,38.62
2021-09-27 00:00:00.000,충청남도,1967,1206,1189,778,39.55
2021-09-27 00:00:00.000,경상북도,1869,1080,1055,814,43.55
2021-09-27 00:00:00.000,강원도,1620,987,917,703,43.4
2021-09-27 00:00:00.000,경상남도,1515,832,804,711,46.93
2021-09-27 00:00:00.000,충청북도,1218,730,716,502,41.22
2021-09-27 00:00:00.000,부산광역시,1246,695,698,548,43.98
2021-09-27 00:00:00.000,전라북도,1145,677,670,475,41.48
2021-09-27 00:00:00.000,전라남도,1190,664,639,551,46.3
2021-09-27 00:00:00.000,,830,641,521,309,37.23
2021-09-27 00:00:00.000,대전광역시,1055,609,597,458,43.41
2021-09-27 00:00:00.000,대구광역시,824,470,463,361,43.81
2021-09-27 00:00:00.000,경기,590,428,357,233,39.49
2021-09-27 00:00:00.000,광주광역시,799,422,418,381,47.68
2021-09-27 00:00:00.000,제주특별자치도,643,339,364,279,43.39
2021-09-27 00:00:00.000,울산광역시,462,263,266,196,42.42
2021-09-27 00:00:00.000,세종특별자치시,324,192,170,154,47.53
2021-09-27 00:00:00.000,인천광역,93,67,50,43,46.24
2021-09-27 00:00:00.000,인천,81,56,50,31,38.27
2021-09-27 00:00:00.000,충남,71,48,37,34,47.89
2021-09-27 00:00:00.000,강원,49,37,33,16,32.65
2021-09-27 00:00:00.000,경북,42,32,21,21,50
2021-09-27 00:00:00.000,충북,40,31,22,18,45
2021-09-27 00:00:00.000,경남,46,29,24,22,47.83
2021-09-27 00:00:00.000,부산광역,29,21,14,15,51.72
2021-09-27 00:00:00.000,전북,35,20,23,12,34.29
2021-09-27 00:00:00.000,대전,28,20,17,11,39.29
2021-09-27 00:00:00.000,★★★★★★★★,22,19,15,7,31.82
2021-09-27 00:00:00.000,광주광역,25,19,15,10,40
2021-09-27 00:00:00.000,부산,29,17,14,15,51.72
2021-09-27 00:00:00.000,대전광역,23,16,12,11,47.83
2021-09-27 00:00:00.000,광주,22,14,13,9,40.91
2021-09-27 00:00:00.000,전남,24,14,18,6,25
2021-09-27 00:00:00.000,대구,18,12,9,9,50
2021-09-27 00:00:00.000,대구광역,14,11,8,6,42.86
2021-09-27 00:00:00.000,제주,14,9,7,7,50
2021-09-27 00:00:00.000,제주도,10,8,7,3,30
2021-09-27 00:00:00.000,울,8,6,8,0,0
2021-09-27 00:00:00.000,서울강북구,5,5,5,0,0
2021-09-27 00:00:00.000,울산광역,6,5,6,0,0
2021-09-27 00:00:00.000,서울시,5,4,2,3,60
2021-09-27 00:00:00.000,울산,6,3,4,2,33.33
2021-09-27 00:00:00.000,산,3,2,3,0,0
2021-09-27 00:00:00.000,남,6,2,3,3,50
2021-09-27 00:00:00.000,북,1,1,1,0,0
2021-09-27 00:00:00.000,기,1,1,1,0,0
2021-09-27 00:00:00.000,경기용인시풍덕천2동,1,1,1,0,0
2021-09-27 00:00:00.000,원,2,1,2,0,0
2021-09-27 00:00:00.000,광주시,2,1,1,1,50
